"","Player","Team","Position","GP","TOI","Goals","Total Assists","First Assists","Second Assists","Total Points","Shots","SH%","iCF","iFF","iSCF","iHDCF","Rush Attempts","Rebounds Created"
"","Connor McDavid","EDM","C","82","1766.8","41","67","39","28","108","275","14.91","434","357","329","173","18","34"
"","Claude Giroux","PHI","C","82","1669.8","34","68","33","35","102","193","17.62","361","252","171","62","8","24"
"","Nikita Kucherov","T.B","R","80","1585.7166666667","39","61","33","28","100","279","13.98","547","423","279","76","15","15"
"","Evgeni Malkin","PIT","C","78","1481.2166666667","42","56","32","24","98","239","17.57","379","306","244","101","5","30"
"","Nathan MacKinnon","COL","C","74","1472.9833333333","39","58","38","20","97","284","13.73","496","393","290","83","22","35"
"","Taylor Hall","N.J","L","76","1454.7666666667","39","54","30","24","93","278","14.03","460","366","273","119","21","21"
"","Anze Kopitar","L.A","C","82","1810.9666666667","35","57","31","26","92","200","17.5","350","264","199","84","13","21"
"","Phil Kessel","PIT","R","82","1532.25","34","58","40","18","92","261","13.03","449","327","244","71","9","31"
"","Blake Wheeler","WPG","R","81","1640.7833333333","23","68","48","20","91","246","9.35","410","327","194","77","4","27"
"","Sidney Crosby","PIT","C","82","1696.5166666667","29","60","33","27","89","247","11.74","412","341","280","142","12","32"
"","Alex Ovechkin","WSH","L","82","1651.8333333333","49","38","20","18","87","355","13.8","705","526","340","105","15","47"
"","Steven Stamkos","T.B","C","78","1464.4","27","59","36","23","86","212","12.74","412","300","214","77","7","20"
"","Brad Marchand","BOS","L","68","1340.6833333333","34","51","29","22","85","182","18.68","308","243","215","96","9","21"
"","Jakub Voracek","PHI","R","82","1595.4833333333","20","65","41","24","85","228","8.77","412","308","200","75","7","32"
"","Mathew Barzal","NYI","C","82","1456.7833333333","22","63","35","28","85","170","12.94","260","207","176","84","4","13"
"","John Tavares","NYI","C","82","1633.8666666667","37","47","28","19","84","258","14.34","448","343","315","132","11","29"
"","Johnny Gaudreau","CGY","L","80","1553.9","24","60","34","26","84","227","10.57","410","318","223","95","13","34"
"","Mikko Rantanen","COL","R","81","1535.9833333333","29","55","29","26","84","178","16.29","305","244","164","62","7","15"
"","Evgeny Kuznetsov","WSH","C","79","1486.1333333333","27","56","33","23","83","187","14.44","313","251","182","96","14","18"
"","Artemi Panarin","CBJ","L","81","1630.5833333333","27","55","35","20","82","228","11.84","470","338","238","61","19","18"
"","David Pastrnak","BOS","R","82","1473.2","35","45","27","18","80","246","14.23","450","337","230","72","10","25"
"","Jamie Benn","DAL","L","82","1625.4833333333","36","43","16","27","79","241","14.94","391","304","257","124","11","32"
"","Tyler Seguin","DAL","C","82","1714.5","40","38","26","12","78","335","11.94","568","444","330","126","13","49"
"","William Karlsson","VGK","C","82","1534.7833333333","43","35","14","21","78","184","23.37","322","263","225","100","15","19"
"","Aleksander Barkov","FLA","C","79","1743.5333333333","27","51","27","24","78","256","10.55","376","319","246","106","10","24"
"","Eric Staal","MIN","C","82","1460.5833333333","42","34","20","14","76","242","17.36","397","299","214","92","22","22"
"","Patrick Kane","CHI","R","82","1655.3","27","49","31","18","76","285","9.47","515","369","251","76","10","30"
"","Sean Couturier","PHI","C","82","1770.5166666667","31","45","33","12","76","227","13.66","377","310","260","128","7","29"
"","Vincent Trocheck","FLA","C","82","1751.8666666667","31","44","22","22","75","287","10.8","494","410","256","88","17","24"
"","Jonathan Marchessault","VGK","C","77","1347.85","27","48","33","15","75","268","10.07","469","350","226","69","13","33"
"","Alexander Radulov","DAL","R","82","1650.4833333333","27","45","31","14","72","217","12.44","388","303","225","108","8","23"
"","Nicklas Backstrom","WSH","C","81","1592.5","21","50","27","23","71","165","12.73","279","223","162","75","2","15"
"","Josh Bailey","NYI","R","76","1359.1833333333","18","53","30","23","71","151","11.92","266","196","166","58","4","16"
"","Brayden Schenn","STL","C","82","1617.4833333333","28","42","23","19","70","210","13.33","355","291","250","96","8","21"
"","Leon Draisaitl","EDM","C","78","1506.6166666667","25","45","34","11","70","194","12.89","324","266","201","82","6","20"
"","Patrik Laine","WPG","R","82","1351.4166666667","44","26","12","14","70","241","18.26","467","354","215","60","12","14"
"","Jonathan Huberdeau","FLA","L","82","1574.9166666667","27","42","26","16","69","204","13.24","341","267","213","100","10","28"
"","Rickard Rakell","ANA","C","77","1495.0833333333","34","35","18","17","69","230","14.78","406","325","260","116","10","22"
"","Mitchell Marner","TOR","C","82","1343.8166666667","22","47","27","20","69","194","11.34","399","277","209","57","6","21"
"","John Carlson","WSH","D","82","2032.1","15","53","26","27","68","237","6.33","467","325","139","20","10","31"
"","Brent Burns","S.J","D","82","2069.9","12","55","30","25","67","332","3.61","775","482","146","18","11","36"
"","Mikael Granlund","MIN","R","77","1446.1833333333","21","46","26","20","67","193","10.88","334","269","188","89","12","18"
"","John Klingberg","DAL","D","82","1974.1166666667","8","59","32","27","67","204","3.92","455","286","129","15","3","29"
"","Joe Pavelski","S.J","C","82","1578.95","22","44","26","18","66","224","9.82","379","311","254","133","8","27"
"","David Perron","VGK","L","70","1246.5833333333","16","50","34","16","66","126","12.7","235","165","125","32","9","20"
"","Vladimir Tarasenko","STL","R","80","1524.5666666667","33","33","16","17","66","306","10.78","609","436","318","74","20","39"
"","Brayden Point","T.B","C","82","1608.8166666667","32","34","18","16","66","217","14.75","378","294","277","126","13","23"
"","Evgenii Dadonov","FLA","R","74","1383.7166666667","28","37","24","13","65","188","14.89","363","288","223","96","12","17"
"","Shayne Gostisbehere","PHI","D","78","1673.5166666667","13","52","21","31","65","221","5.88","458","320","94","13","3","36"
"","Sebastian Aho","CAR","R","78","1397.6166666667","29","36","24","12","65","200","14.5","390","290","220","90","13","23"
"","Clayton Keller","ARI","C","82","1483.1","23","42","23","19","65","212","10.85","385","303","220","87","8","32"
"","Jason Zucker","MIN","L","82","1390.8","33","31","19","12","64","222","14.86","338","284","215","125","6","26"
"","Yanni Gourde","T.B","C","82","1324.95","25","39","23","16","64","136","18.38","240","190","157","85","12","17"
"","Teuvo Teravainen","CAR","L","82","1384.75","23","41","24","17","64","185","12.43","352","266","170","63","8","23"
"","Filip Forsberg","NSH","L","67","1170.7666666667","26","38","30","8","64","179","14.53","349","266","172","63","4","15"
"","Sean Monahan","CGY","C","74","1382.4666666667","31","33","22","11","64","202","15.35","352","286","275","132","6","21"
"","Jack Eichel","BUF","C","67","1349.6","25","39","23","16","64","246","10.16","434","338","192","54","6","21"
"","Patrice Bergeron","BOS","C","64","1244","30","33","21","12","63","224","13.39","398","315","246","86","11","16"
"","Victor Hedman","T.B","D","77","1990.5","17","46","23","23","63","216","7.87","469","312","115","22","7","23"
"","Dylan Larkin","DET","C","82","1627.1666666667","16","47","25","22","63","232","6.9","421","335","203","75","10","17"
"","Auston Matthews","TOR","C","62","1123.95","34","29","18","11","63","187","18.18","313","255","241","85","11","15"
"","Erik Karlsson","OTT","D","71","1898.5666666667","9","53","28","25","62","196","4.59","478","296","119","19","5","27"
"","Anders Lee","NYI","L","82","1415.8833333333","40","22","15","7","62","208","19.23","317","273","249","163","7","22"
"","Mark Stone","OTT","R","58","1199.0333333333","20","42","26","16","62","132","15.15","239","186","148","70","8","17"
"","Gabriel Landeskog","COL","L","78","1571.1666666667","25","37","18","19","62","183","13.66","312","245","198","113","9","17"
"","Dustin Brown","L.A","R","81","1606.75","28","33","21","12","61","222","12.61","368","302","219","118","6","15"
"","Ryan Getzlaf","ANA","C","56","1199.8333333333","11","50","34","16","61","117","9.4","242","182","103","36","7","14"
"","Logan Couture","S.J","C","78","1446.7","34","27","18","9","61","204","16.67","377","274","194","70","13","24"
"","Ryan O'Reilly","BUF","C","81","1686.1666666667","24","37","26","11","61","230","10.43","358","314","177","89","8","18"
"","William Nylander","TOR","C","82","1368.45","20","41","28","13","61","184","10.87","380","265","234","76","11","18"
"","Viktor Arvidsson","NSH","L","78","1384.3666666667","29","32","13","19","61","247","11.74","425","345","214","103","20","20"
"","Drew Doughty","L.A","D","82","2200.5166666667","10","50","25","25","60","205","4.88","401","277","118","23","6","27"
"","Reilly Smith","VGK","R","67","1200.9333333333","22","38","23","15","60","162","13.58","277","219","155","67","9","15"
"","Mark Scheifele","WPG","C","60","1240.7","23","37","24","13","60","125","18.4","216","176","161","74","5","12"
"","Nikolaj Ehlers","WPG","L","82","1318.6","29","31","21","10","60","231","12.55","422","313","201","65","19","16"
"","P.K. Subban","NSH","D","82","1977.4","16","43","28","15","59","207","7.73","431","292","55","3","5","23"
"","Jordan Eberle","NYI","C","81","1301.5166666667","25","34","19","15","59","183","13.66","290","240","203","100","9","16"
"","Matt Duchene","COL, OTT","C","82","1503.2333333333","27","32","22","10","59","190","14.21","328","263","217","112","4","19"
"","Jaden Schwartz","STL","L","62","1202.35","24","35","25","10","59","157","15.29","269","218","179","77","10","16"
"","Torey Krug","BOS","D","76","1550.5","14","45","26","19","59","197","7.11","416","274","112","17","5","25"
"","J.T. Miller","NYR, T.B","C, L","82","1395.6666666667","23","35","19","16","58","143","16.08","238","198","155","83","7","14"
"","Tyson Barrie","COL","D","68","1543.4","14","43","24","19","57","178","7.87","396","246","94","12","6","25"
"","Seth Jones","CBJ","D","78","1918.95","16","41","25","16","57","249","6.43","485","361","108","21","6","22"
"","Kyle Connor","WPG","L","76","1284.9333333333","31","26","13","13","57","192","16.15","289","241","207","100","5","22"
"","Henrik Zetterberg","DET","C","82","1598.7333333333","11","45","32","13","56","180","6.11","332","253","163","57","6","15"
"","Thomas Vanek","CBJ, VAN","L","80","1127.0166666667","24","32","23","9","56","168","14.29","266","219","155","85","11","17"
"","Keith Yandle","FLA","D","82","2008.1","8","48","25","23","56","179","4.47","360","249","75","6","7","25"
"","Derek Stepan","ARI","C","82","1579.9166666667","14","42","21","21","56","209","6.7","345","278","188","78","13","26"
"","Mike Hoffman","OTT","L","82","1509.3666666667","22","34","18","16","56","257","8.56","449","338","181","57","11","29"
"","Daniel Sedin","VAN","L","81","1236.9","23","32","20","12","55","189","12.17","310","258","208","101","5","22"
"","Nazem Kadri","TOR","C","80","1340.75","32","23","12","11","55","211","15.17","367","286","226","100","7","14"
"","Erik Haula","VGK","L","76","1320.4","29","26","11","15","55","175","16.57","300","246","199","85","7","13"
"","Brock Boeser","VAN","R","62","1084.5333333333","29","26","13","13","55","179","16.2","341","240","177","53","6","14"
"","James van Riemsdyk","TOR","L","81","1206.4166666667","36","18","11","7","54","248","14.52","431","360","311","183","14","35"
"","Alex Pietrangelo","STL","D","78","2007.45","15","39","19","20","54","216","6.94","417","295","115","17","10","26"
"","Evander Kane","BUF, S.J","L","78","1526.95","29","25","12","13","54","308","9.42","492","399","280","156","9","35"
"","Ryan Johansen","NSH","C","79","1465.35","15","39","17","22","54","129","11.63","211","171","125","62","2","14"
"","Brendan Gallagher","MTL","R","82","1324.9","31","23","13","10","54","278","11.15","478","370","285","165","24","34"
"","Paul Stastny","STL, WPG","C","82","1500.9833333333","16","37","19","18","53","159","10.06","243","217","185","119","7","18"
"","Roman Josi","NSH","D","75","1835.2833333333","14","39","23","16","53","253","5.53","487","326","143","23","8","30"
"","Mats Zuccarello","NYR","R","80","1513.9","16","37","23","14","53","178","8.99","291","239","165","73","13","18"
"","Jonathan Toews","CHI","C","74","1457.1","20","32","21","11","52","211","9.48","341","266","217","94","16","25"
"","Jake Gardiner","TOR","D","82","1847.0666666667","5","47","22","25","52","133","3.76","317","201","95","13","5","14"
"","Morgan Rielly","TOR","D","76","1641.5833333333","6","46","25","21","52","182","3.3","371","248","95","7","9","25"
"","Nick Schmaltz","CHI","C","78","1422.0333333333","21","31","15","16","52","118","17.8","218","158","144","60","8","11"
"","Alex DeBrincat","CHI","R","82","1213.7666666667","28","24","15","9","52","181","15.47","358","252","206","54","7","12"
"","Nico Hischier","N.J","C","82","1337.3666666667","20","32","21","11","52","180","11.11","289","237","190","108","8","23"
"","Justin Williams","CAR","R","82","1360.2166666667","16","35","20","15","51","198","8.08","357","274","178","83","10","16"
"","Ryan Suter","MIN","D","78","2088.6333333333","6","45","24","21","51","149","4.03","323","214","69","16","3","19"
"","Kris Letang","PIT","D","79","2000.9666666667","9","42","15","27","51","222","4.05","443","297","103","21","3","30"
"","Kyle Turris","NSH, OTT","C","76","1262.6833333333","16","35","17","18","51","145","11.03","272","208","143","53","5","16"
"","Craig Smith","NSH","R","79","1215.15","25","26","16","10","51","229","10.92","372","319","239","117","12","24"
"","Alex Galchenyuk","MTL","L","82","1331.2","19","32","16","16","51","213","8.92","382","283","197","76","9","35"
"","Henrik Sedin","VAN","C","82","1274.9666666667","3","47","13","34","50","67","4.48","125","96","76","38","4","8"
"","Adam Henrique","ANA, N.J","C","81","1440.6","24","26","17","9","50","151","15.89","263","212","182","100","12","14"
"","Tyler Johnson","T.B","C","81","1376.3333333333","21","29","14","15","50","186","11.29","311","263","203","84","15","28"
"","Matt Dumba","MIN","D","82","1952.8166666667","14","36","19","17","50","176","7.95","369","253","71","12","6","15"
"","Sam Reinhart","BUF","C","82","1402.3166666667","25","25","14","11","50","188","13.3","299","259","203","120","6","16"
"","Corey Perry","ANA","R","71","1262.1666666667","17","32","22","10","49","169","10.06","287","225","193","100","11","24"
"","Patric Hornqvist","PIT","R","70","1212.6","29","20","14","6","49","247","11.74","377","325","280","181","4","23"
"","Nick Bjugstad","FLA","C","82","1239.8166666667","19","30","21","9","49","230","8.26","360","311","225","103","12","27"
"","Jeff Skinner","CAR","L","82","1370.05","24","25","13","12","49","277","8.66","490","383","308","124","19","33"
"","Matthew Tkachuk","CGY","L","68","1173.05","24","25","14","11","49","188","12.77","309","270","216","138","3","24"
"","Ryan Nugent-Hopkins","EDM","C","62","1121.45","24","24","16","8","48","151","15.89","254","195","165","75","7","15"
"","Vladislav Namestnikov","NYR, T.B","C","81","1384.1","22","26","12","14","48","155","14.19","247","204","193","109","8","19"
"","Jake Guentzel","PIT","C","82","1351.8666666667","22","26","15","11","48","171","12.87","296","239","197","101","6","24"
"","Anthony Mantha","DET","R","80","1383.5","24","24","16","8","48","190","12.63","331","267","191","97","9","15"
"","Kevin Fiala","NSH","L","80","1211.8166666667","23","25","14","11","48","187","12.3","354","255","211","95","9","18"
"","Pierre-Luc Dubois","CBJ","C","82","1364.0333333333","20","28","12","16","48","165","12.12","274","222","193","97","8","15"
"","Patrick Marleau","TOR","C","82","1393","27","20","10","10","47","204","13.24","323","271","230","116","7","10"
"","T.J. Oshie","WSH","R","74","1362.45","18","29","17","12","47","127","14.17","240","194","164","74","11","13"
"","Alex Killorn","T.B","L","82","1352.8333333333","15","32","17","15","47","156","9.62","277","224","171","68","11","12"
"","Tyler Toffoli","L.A","C","82","1321.7333333333","24","23","9","14","47","251","9.56","440","340","249","99","14","22"
"","Mika Zibanejad","NYR","C","72","1293.4833333333","27","20","10","10","47","212","12.74","367","298","192","92","7","19"
"","Danton Heinen","BOS","C","77","1156.7","16","31","12","19","47","135","11.85","231","178","142","59","8","14"
"","Travis Konecny","PHI","C","81","1207.4833333333","24","23","13","10","47","177","13.56","290","236","188","86","13","18"
"","Alexander Steen","STL","L","76","1420.7333333333","15","31","18","13","46","168","8.93","303","216","150","66","10","21"
"","Jordan Staal","CAR","C","79","1520.8166666667","19","27","14","13","46","160","11.88","276","224","197","119","5","13"
"","Derick Brassard","OTT, PIT","C","72","1276.75","21","25","17","8","46","197","10.66","317","258","192","88","12","23"
"","Wayne Simmonds","PHI","R","75","1356.5666666667","24","22","12","10","46","176","13.64","292","242","206","125","1","24"
"","Cam Atkinson","CBJ","R","65","1228.6","24","22","16","6","46","231","10.39","380","303","234","110","9","34"
"","Tomas Hertl","S.J","C","79","1430.0166666667","22","24","14","10","46","175","12.57","332","264","241","133","7","29"
"","Jonathan Drouin","MTL","C","77","1355.15","13","33","17","16","46","164","7.93","299","221","152","58","12","10"
"","Mikko Koivu","MIN","C","82","1515.95","14","31","16","15","45","170","8.24","284","234","169","79","7","23"
"","Dustin Byfuglien","WPG","D","69","1679.3833333333","8","37","13","24","45","193","4.15","372","283","97","40","10","21"
"","Mikael Backlund","CGY","C","82","1559.8833333333","14","31","19","12","45","214","6.54","372","299","197","82","21","15"
"","Max Domi","ARI","L","82","1369.9","9","36","22","14","45","150","6","315","211","151","57","6","32"
"","David Krejci","BOS","C","64","1080.05","17","27","17","10","44","119","14.29","201","160","120","46","7","14"
"","James Neal","VGK","L","71","1219.4333333333","25","19","11","8","44","202","12.38","362","275","214","81","11","21"
"","Kyle Okposo","BUF","R","76","1294.0666666667","15","29","16","13","44","161","9.32","279","211","160","74","6","25"
"","Kyle Palmieri","N.J","R","62","1073.2","24","20","9","11","44","182","13.19","327","262","171","62","8","19"
"","Kevin Hayes","NYR","C","76","1318.85","25","19","10","9","44","172","14.53","268","219","155","84","12","16"
"","Dougie Hamilton","CGY","D","82","1765.5333333333","17","27","15","12","44","270","6.3","561","379","163","29","9","22"
"","Will Butcher","N.J","D","81","1301.0833333333","5","39","19","20","44","88","5.68","239","153","63","10","3","16"
"","Elias Lindholm","CAR","C","81","1449.3166666667","16","28","18","10","44","153","10.46","267","217","166","94","8","22"
"","Bo Horvat","VAN","C","64","1238.3833333333","22","22","16","6","44","158","13.92","253","204","175","95","11","10"
"","Bryan Little","WPG","C","82","1388.5666666667","16","27","12","15","43","129","12.4","231","168","147","59","6","18"
"","Patrick Maroon","EDM, N.J","L","74","1223.5333333333","17","26","16","10","43","141","12.06","247","209","160","97","4","20"
"","Tyler Bozak","TOR","C","81","1267.05","11","32","21","11","43","154","7.14","252","198","162","86","6","16"
"","Alexander Kerfoot","COL","C","79","1061.9","19","24","15","9","43","82","23.17","137","106","98","42","4","7"
"","Pavel Buchnevich","NYR","R","74","1111.05","14","29","18","11","43","136","10.29","266","191","136","63","5","23"
"","Jake DeBrusk","BOS","L","70","1005.9833333333","16","27","14","13","43","143","11.19","246","198","151","62","13","14"
"","Jeff Petry","MTL","D","82","1926.5833333333","12","30","21","9","42","178","6.74","378","240","87","24","5","20"
"","Jake Muzzin","L.A","D","74","1602.1833333333","8","34","14","20","42","154","5.19","353","231","88","9","6","17"
"","Oliver Ekman-Larsson","ARI","D","82","1939.9666666667","14","28","14","14","42","202","6.93","442","279","121","18","7","29"
"","Nick Leddy","NYI","D","80","1793.6833333333","10","32","15","17","42","153","6.54","312","210","69","9","3","22"
"","Riley Nash","BOS","C","76","1171.1","15","26","13","13","41","113","13.27","188","152","125","61","8","15"
"","Ryan Spooner","BOS, NYR","C","59","902.21666666667","13","28","15","13","41","107","12.15","161","133","89","35","4","6"
"","Micheal Ferland","CGY","L","77","1156.4833333333","21","20","16","4","41","144","14.58","265","221","176","105","5","21"
"","Ryan Dzingel","OTT","L","79","1303.1","23","18","12","6","41","136","16.91","238","184","162","78","5","15"
"","Colin Miller","VGK","D","82","1586.1833333333","10","31","18","13","41","177","5.65","420","265","99","11","7","27"
"","Rasmus Ristolainen","BUF","D","73","1934.45","6","35","18","17","41","182","3.3","353","253","67","10","4","11"
"","Ivan Provorov","PHI","D","82","1980.5333333333","17","24","11","13","41","203","8.37","393","263","94","19","8","22"
"","Gustav Nyquist","DET","R","82","1463.8","21","19","16","3","40","213","9.86","343","283","204","99","10","14"
"","Jakob Silfverberg","ANA","R","77","1382.95","17","23","13","10","40","187","9.09","351","267","196","87","9","25"
"","Zach Hyman","TOR","C","82","1423.3333333333","15","25","17","8","40","149","10.07","239","203","176","102","11","15"
"","Tanner Pearson","L.A","L","82","1309.35","15","25","13","12","40","180","8.33","319","263","181","82","11","23"
"","Chris Tierney","S.J","C","82","1311.9833333333","17","23","14","9","40","118","14.41","187","158","129","73","11","7"
"","Oliver Bjorkstrand","CBJ","R","82","1171.6","11","29","17","12","40","163","6.75","291","232","149","45","9","16"
"","Kevin Labanc","S.J","R","77","1105.05","11","29","20","9","40","156","7.05","296","222","167","51","5","18"
"","Mikhail Sergachev","T.B","D","79","1213.4666666667","9","31","17","14","40","141","6.38","330","222","91","17","4","19"
"","Mathieu Perreault","WPG","C","70","1012.0833333333","17","22","9","13","39","139","12.23","230","184","148","78","5","12"
"","Mark Giordano","CGY","D","82","2032.5833333333","13","25","6","19","38","214","6.07","491","309","108","15","10","32"
"","Lars Eller","WSH","C","81","1239.35","18","20","14","6","38","161","11.18","299","219","152","69","12","19"
"","Bryan Rust","PIT","R","69","1107.3833333333","13","25","16","9","38","123","10.57","217","183","148","75","7","15"
"","Aaron Ekblad","FLA","D","82","1917.9","16","22","6","16","38","189","8.47","399","283","119","25","4","17"
"","Ondrej Kase","ANA","R","66","918.88333333333","20","18","12","6","38","146","13.7","239","190","139","57","9","8"
"","Derek Ryan","CAR","C","80","1248.4833333333","15","23","12","11","38","135","11.11","247","202","168","91","7","21"
"","Carl Soderberg","COL","C","77","1336.1833333333","16","21","13","8","37","150","10.67","256","204","151","84","8","14"
"","Max Pacioretty","MTL","L","64","1216.7833333333","17","20","11","9","37","212","8.02","391","293","197","83","16","29"
"","Mikkel Boedker","S.J","L","74","988.4","15","22","12","10","37","119","12.61","198","163","136","58","3","13"
"","Jared Spurgeon","MIN","D","61","1497.2833333333","9","28","12","16","37","110","8.18","234","161","58","18","3","15"
"","Chris Kreider","NYR","L","58","905.86666666667","16","21","11","10","37","137","11.68","236","196","145","82","8","12"
"","Charlie Coyle","MIN","C","66","1091.1833333333","11","26","16","10","37","117","9.4","199","158","113","61","3","7"
"","Josh Manson","ANA","D","80","1628.2833333333","7","30","13","17","37","117","5.98","223","170","63","17","11","10"
"","Alex Tuch","VGK","R","78","1189.7","15","22","15","7","37","171","8.77","302","244","219","103","11","28"
"","Adrian Kempe","L.A","L","81","1079.8166666667","16","21","10","11","37","119","13.45","212","161","118","40","5","9"
"","Christian Dvorak","ARI","C","78","1281.3166666667","15","22","15","7","37","151","9.93","242","212","182","112","9","23"
"","Zach Werenski","CBJ","D","77","1738.35","16","21","12","9","37","207","7.73","383","283","113","27","5","23"
"","Joe Thornton","S.J","C","47","862.21666666667","13","23","11","12","36","75","17.33","132","104","70","16","2","7"
"","Michael Grabner","N.J, NYR","R","80","1185.45","27","9","5","4","36","167","16.17","260","216","167","93","22","12"
"","Tyler Myers","WPG","D","82","1756.95","6","30","18","12","36","150","4","304","211","69","12","4","22"
"","Nate Schmidt","VGK","D","76","1690.3166666667","5","31","14","17","36","103","4.85","255","161","62","15","4","13"
"","Timo Meier","S.J","R","81","1204.2833333333","21","15","5","10","36","210","10","360","295","246","126","9","24"
"","Anthony Beauvillier","NYI","C","71","1031.4","21","15","10","5","36","132","15.91","219","170","158","73","7","5"
"","Alex Goligoski","ARI","D","78","1813.85","12","23","16","7","35","119","10.08","279","173","72","17","7","15"
"","Andrew Cogliano","ANA","L","80","1216.1666666667","12","23","16","7","35","175","6.86","303","237","156","66","13","16"
"","Justin Abdelkader","DET","L","75","1241.3166666667","13","22","9","13","35","110","11.82","201","168","141","78","7","16"
"","Paul Byron","MTL","L","82","1322.2833333333","20","15","10","5","35","115","17.39","203","171","165","112","8","24"
"","Richard Panik","ARI, CHI","R","72","1094.2","14","21","15","6","35","136","10.29","268","194","149","75","8","21"
"","Calle Jarnkrok","NSH","C","68","1080.2","16","19","10","9","35","105","15.24","184","144","106","43","8","10"
"","Brock Nelson","NYI","C","82","1207.7333333333","19","16","6","10","35","138","13.77","249","185","174","89","5","9"
"","Ondrej Palat","T.B","L","56","951.78333333333","11","24","11","13","35","109","10.09","195","152","122","55","6","11"
"","Brandon Saad","CHI","L","82","1435.3333333333","18","17","12","5","35","237","7.59","397","319","273","132","13","22"
"","Tom Wilson","WSH","R","78","1247.1333333333","14","21","12","9","35","123","11.38","234","180","143","73","6","18"
"","Colton Parayko","STL","D","82","1854.3833333333","6","29","17","12","35","212","2.83","394","287","82","11","12","20"
"","Alexander Wennberg","CBJ","C","66","1196.3","8","27","15","12","35","74","10.81","127","104","85","42","2","6"
"","Jesper Bratt","N.J","L","74","1128.6","13","22","12","10","35","100","13","175","139","87","35","5","6"
"","Jason Pominville","BUF","R","82","1222.05","16","18","10","8","34","168","9.52","278","221","124","53","8","18"
"","Rick Nash","BOS, NYR","L, R","71","1210.9","21","13","8","5","34","230","9.13","365","311","234","134","15","18"
"","Blake Comeau","COL","L","79","1253.9166666667","13","21","16","5","34","123","10.57","219","167","109","38","4","11"
"","Alexander Edler","VAN","D","70","1699.4166666667","6","28","16","12","34","172","3.49","354","230","72","11","7","13"
"","Milan Lucic","EDM","L","82","1308.7666666667","10","24","11","13","34","147","6.8","282","226","181","100","11","25"
"","Tomas Tatar","DET, VGK","L","82","1333.7666666667","20","14","5","9","34","174","11.49","317","250","183","59","8","16"
"","Mattias Ekholm","NSH","D","81","1909.7666666667","10","24","16","8","34","135","7.41","286","194","75","12","5","15"
"","Ryan Strome","EDM","C","82","1248.05","13","21","14","7","34","147","8.84","250","195","156","63","8","17"
"","Mattias Janmark","DAL","C","81","1371.0166666667","19","15","11","4","34","136","13.97","228","177","134","81","7","13"
"","Valtteri Filppula","PHI","C","81","1334.6166666667","11","22","13","9","33","71","15.49","124","100","86","39","3","7"
"","Frans Nielsen","DET","C","79","1250.3833333333","16","17","11","6","33","134","11.94","237","190","122","43","9","15"
"","David Backes","BOS","R","57","877.53333333333","14","19","14","5","33","160","8.75","240","214","130","61","10","15"
"","Kyle Brodziak","STL","C","81","1090.4833333333","10","23","12","11","33","113","8.85","177","142","84","32","7","9"
"","Mike Green","DET","D","66","1457.4166666667","8","25","7","18","33","132","6.06","279","184","90","17","4","11"
"","Bobby Ryan","OTT","R","62","1019.3833333333","11","22","12","10","33","112","9.82","236","166","115","50","7","10"
"","Nick Foligno","CBJ","L","72","1321.2166666667","15","18","7","11","33","137","10.95","208","171","130","68","10","12"
"","Justin Braun","S.J","D","81","1727.6","5","28","15","13","33","115","4.35","251","170","41","4","4","17"
"","Jesper Fast","NYR","R","71","1056.6","13","20","14","6","33","80","16.25","134","113","100","58","2","3"
"","Radek Faksa","DAL","C","79","1206.4333333333","17","16","8","8","33","119","14.29","189","150","117","63","8","16"
"","Andreas Athanasiou","DET","L","71","1087.3","16","17","10","7","33","170","9.41","322","239","162","61","9","5"
"","Christian Fischer","ARI","R","79","1098.2166666667","15","18","10","8","33","154","9.74","240","196","153","91","9","28"
"","Duncan Keith","CHI","D","82","1953.8166666667","2","30","6","24","32","187","1.07","400","247","85","5","5","16"
"","Marc-Edouard Vlasic","S.J","D","81","1826.4333333333","11","21","4","17","32","161","6.83","337","218","81","21","5","22"
"","TJ Brodie","CGY","D","73","1728.65","4","28","7","21","32","118","3.39","260","173","61","15","7","18"
"","Ryan Ellis","NSH","D","44","1027.6833333333","9","23","12","11","32","110","8.18","220","159","40","6","5","15"
"","Sami Vatanen","ANA, N.J","D","72","1612.8833333333","4","28","14","14","32","145","2.76","295","201","62","6","3","16"
"","Cam Fowler","ANA","D","67","1665.1833333333","8","24","8","16","32","122","6.56","275","163","106","25","7","22"
"","Riley Sheahan","DET, PIT","C","81","1188.1833333333","11","21","12","9","32","109","10.09","173","146","109","49","8","11"
"","Nino Niederreiter","MIN","R","63","945.08333333333","18","14","10","4","32","133","13.53","219","182","146","83","3","16"
"","Joonas Donskoi","S.J","R","66","988.21666666667","14","18","13","5","32","129","10.85","201","157","144","72","2","18"
"","Boone Jenner","CBJ","C","75","1234.6","13","19","12","7","32","187","6.95","310","257","179","97","10","18"
"","Devin Shore","DAL","C","82","1265.1333333333","11","21","14","7","32","123","8.94","221","175","164","84","8","26"
"","Miles Wood","N.J","L","76","946.88333333333","19","13","5","8","32","170","11.18","262","226","142","67","15","13"
"","Ryan Pulock","NYI","D","68","1251.6","10","22","10","12","32","184","5.43","358","249","89","13","7","18"
"","Brandon Montour","ANA","D","80","1637.5833333333","9","23","12","11","32","160","5.63","327","235","90","18","8","17"
"","Noah Hanifin","CAR","D","79","1489.95","10","22","11","11","32","165","6.06","341","217","98","29","3","29"
"","Charlie McAvoy","BOS","D","63","1395.2833333333","7","25","10","15","32","77","9.09","187","122","52","9","4","15"
"","Vladimir Sobotka","STL","L","81","1387.0666666667","11","20","14","6","31","136","8.09","229","171","118","43","8","10"
"","Darren Helm","DET","L","75","1167.4666666667","13","18","13","5","31","141","9.22","223","184","100","34","13","7"
"","Artem Anisimov","CHI","C","72","1208.7833333333","20","11","8","3","31","130","15.38","226","169","159","79","5","18"
"","Sam Gagner","VAN","C","74","1118.2166666667","10","21","11","10","31","164","6.1","270","212","116","48","4","18"
"","Carl Hagelin","PIT","L","81","1291.3","10","21","11","10","31","169","5.92","256","207","131","55","15","19"
"","Dmitry Orlov","WSH","D","82","1896.5666666667","10","21","6","15","31","125","8","243","167","72","10","7","13"
"","Justin Faulk","CAR","D","76","1692.35","8","23","9","14","31","211","3.79","446","294","119","26","9","32"
"","Victor Rask","CAR","C","71","1092.05","14","17","8","9","31","126","11.11","231","183","120","40","7","19"
"","Hampus Lindholm","ANA","D","69","1569.05","13","18","9","9","31","131","9.92","278","179","71","11","8","19"
"","Ryan Hartman","CHI, NSH","L, R","78","1018.85","11","20","13","7","31","129","8.53","248","184","148","66","7","12"
"","Brock McGinn","CAR","L","80","1159.7333333333","16","14","6","8","30","160","10","327","245","187","103","7","22"
"","Charles Hudon","MTL","L","72","1010.0833333333","10","20","13","7","30","179","5.59","286","213","147","63","16","23"
"","Jaccob Slavin","CAR","D","82","1852.2","8","22","11","11","30","154","5.19","300","208","73","16","8","17"
"","Josh Anderson","CBJ","R","63","1136.3833333333","19","11","5","6","30","188","10.11","318","254","190","82","11","10"
"","Conor Sheary","PIT","L","79","1101.8333333333","18","12","6","6","30","142","12.68","244","194","152","67","5","18"
"","Brendan Perlini","ARI","L","74","1073.8666666667","17","13","7","6","30","129","13.18","280","201","143","54","12","7"
"","Nolan Patrick","PHI","C","73","1001.9166666667","13","17","11","6","30","127","10.24","205","167","138","68","5","16"
"","Mike Cammalleri","EDM, L.A","C, L","66","908.93333333333","7","22","12","10","29","128","5.47","220","172","107","39","5","9"
"","Chris Kunitz","T.B","L","82","979.6","13","16","9","7","29","81","16.05","133","105","78","39","5","6"
"","Andrew Ladd","NYI","L","73","1160.2","12","17","11","6","29","112","10.71","220","169","148","77","6","8"
"","Matt Niskanen","WSH","D","68","1537.2833333333","7","22","12","10","29","120","5.83","277","182","68","9","4","17"
"","Jamie McGinn","FLA","L","76","1022.5166666667","13","16","11","5","29","117","11.11","182","151","110","56","8","9"
"","Ryan McDonagh","NYR, T.B","D","63","1469.65","4","25","13","12","29","99","4.04","201","132","78","15","4","9"
"","Jean-Gabriel Pageau","OTT","C","78","1305.6333333333","14","15","7","8","29","147","9.52","241","206","132","82","9","12"
"","Sven Baertschi","VAN","L","53","827.1","14","15","10","5","29","83","16.87","144","108","88","40","9","10"
"","Joel Armia","WPG","R","79","995.51666666667","12","17","11","6","29","128","9.38","220","167","122","61","6","12"
"","Olli Maatta","PIT","D","82","1537.9833333333","7","22","10","12","29","164","4.27","318","215","66","9","5","20"
"","Shea Theodore","VGK","D","61","1241.4833333333","6","23","14","9","29","144","4.17","262","187","93","10","10","15"
"","David Desharnais","NYR","C","71","927.03333333333","6","22","8","14","28","55","10.91","98","70","64","30","3","5"
"","Jimmy Vesey","NYR","L","79","1132.1666666667","17","11","8","3","28","136","12.5","240","187","162","95","7","16"
"","Connor Brown","TOR","R","82","1231.1","14","14","10","4","28","119","11.76","203","172","134","63","5","8"
"","Andrew Copp","WPG","C","82","1125.9666666667","9","19","8","11","28","96","9.38","186","135","101","52","7","9"
"","Jared McCann","FLA","C","68","901.35","9","19","11","8","28","143","6.29","212","168","106","40","9","15"
"","Niklas Kronwall","DET","D","79","1463.2333333333","4","23","8","15","27","76","5.26","151","97","36","7","5","4"
"","Justin Schultz","PIT","D","63","1229.3166666667","4","23","15","8","27","109","3.67","235","168","54","10","1","14"
"","Cody Eakin","VGK","C","80","1162.8","11","16","7","9","27","107","10.28","195","144","115","45","14","7"
"","Tyler Pitlick","DAL","C","80","1094.3666666667","14","13","5","8","27","129","10.85","244","181","141","56","7","11"
"","Brett Connolly","WSH","R","70","840.2","15","12","8","4","27","67","22.39","148","104","95","32","3","7"
"","Stefan Noesen","N.J","R","72","956.63333333333","13","14","10","4","27","127","10.24","193","167","104","61","6","7"
"","Mike Matheson","FLA","D","81","1728.3166666667","10","17","9","8","27","167","5.99","320","237","95","17","8","12"
"","Esa Lindell","DAL","D","80","1766.2833333333","7","20","5","15","27","137","5.11","265","181","65","9","9","18"
"","Colton Sissons","NSH","C","81","1303.6333333333","9","18","8","10","27","120","7.5","192","153","128","69","7","7"
"","Nick Ritchie","ANA","L","76","1001.8333333333","10","17","6","11","27","122","8.2","235","193","150","87","14","18"
"","Jakub Vrana","WSH","L","73","912.4","13","14","9","5","27","133","9.77","209","176","148","74","11","14"
"","Jason Spezza","DAL","C","78","1014.4666666667","8","18","13","5","26","138","5.8","275","201","130","64","6","14"
"","Tomas Plekanec","MTL, TOR","C","77","1165.4833333333","6","20","14","6","26","144","4.17","228","181","121","46","14","8"
"","Dion Phaneuf","L.A, OTT","D","79","1579.7666666667","6","20","11","9","26","134","4.48","256","184","54","7","2","18"
"","Brent Seabrook","CHI","D","81","1635.9833333333","7","19","8","11","26","136","5.15","307","195","63","14","6","19"
"","Travis Zajac","N.J","C","63","1128.2","12","14","7","7","26","91","13.19","152","125","108","59","2","9"
"","Trevor Lewis","L.A","C","68","1035.95","14","12","10","2","26","134","10.45","230","184","121","57","13","20"
"","Patrik Berglund","STL","C","57","920.88333333333","17","9","7","2","26","112","15.18","183","149","110","42","7","8"
"","Brandon Sutter","VAN","C","61","1056.25","11","15","11","4","26","106","10.38","155","133","88","41","14","6"
"","Brian Gibbons","N.J","L","59","851.4","12","14","11","3","26","72","16.67","110","90","65","35","4","5"
"","Matt Nieto","COL","L","74","1103.2666666667","15","11","6","5","26","85","17.65","146","114","91","41","6","8"
"","Darnell Nurse","EDM","D","82","1824.35","6","20","8","12","26","194","3.09","366","277","102","28","9","20"
"","Josh Morrissey","WPG","D","81","1656.5333333333","7","19","7","12","26","102","6.86","215","142","45","9","3","15"
"","Sam Bennett","CGY","C","82","1180.8333333333","11","15","9","6","26","157","7.01","293","230","184","83","14","25"
"","Erik Johnson","COL","D","62","1577.05","9","16","10","6","25","168","5.36","291","211","74","19","6","15"
"","Michael Frolik","CGY","R","70","1184.5833333333","10","15","7","8","25","167","5.99","281","230","146","64","11","18"
"","Nick Bonino","NSH","C","71","1110.1333333333","12","13","8","5","25","83","14.46","144","121","85","46","2","5"
"","Thomas Hickey","NYI","D","69","1247.0333333333","5","20","11","9","25","87","5.75","210","130","52","13","1","10"
"","Alec Martinez","L.A","D","77","1760.4166666667","9","16","10","6","25","111","8.11","229","153","57","11","4","8"
"","Tobias Rieder","ARI, L.A","C, R","78","1142.8833333333","12","13","10","3","25","114","10.53","213","167","117","66","11","17"
"","Blake Coleman","N.J","C","79","1137.1333333333","13","12","10","2","25","146","8.9","245","199","146","77","13","9"
"","Phillip Danault","MTL","C","52","862.56666666667","8","17","11","6","25","94","8.51","151","119","92","53","4","13"
"","Brady Skjei","NYR","D","82","1724.05","4","21","9","12","25","153","2.61","282","202","96","25","4","15"
"","Mark Jankowski","CGY","C","72","961.63333333333","17","8","4","4","25","118","14.41","211","172","135","68","8","17"
"","Martin Frk","DET","R","68","699.53333333333","11","14","8","6","25","100","11","189","143","71","24","1","15"
"","Vinnie Hinostroza","CHI","L","50","690.98333333333","7","18","12","6","25","86","8.14","183","120","105","34","4","10"
"","Andre Burakovsky","WSH","L","56","774.95","12","13","8","5","25","84","14.29","170","123","107","38","9","5"
"","Pavel Zacha","N.J","C","69","991.61666666667","8","17","12","5","25","112","7.14","191","160","128","54","9","9"
"","Thomas Chabot","OTT","D","63","1103.1833333333","9","16","9","7","25","94","9.57","181","115","49","9","1","13"
"","Evan Rodrigues","BUF","L","48","668.6","7","18","7","11","25","91","7.69","166","130","68","21","1","11"
"","Alex Iafallo","L.A","C","75","1132.7666666667","9","16","10","6","25","129","6.98","233","183","140","64","7","11"
"","Zdeno Chara","BOS","D","73","1671.95","7","17","7","10","24","144","4.86","323","210","76","13","5","24"
"","Scott Hartnell","NSH","L","62","745.11666666667","13","11","8","3","24","82","15.85","133","107","79","41","5","5"
"","Dan Hamhuis","DAL","D","80","1615.05","3","21","8","13","24","66","4.55","161","97","41","10","4","8"
"","Zach Parise","MIN","L","42","717.48333333333","15","9","5","4","24","119","12.61","173","148","117","63","6","16"
"","Colton Sceviour","FLA","C","76","1021.4","11","13","8","5","24","141","7.8","219","182","114","63","12","17"
"","Derek Grant","ANA","C","66","732.46666666667","12","12","6","6","24","65","18.46","112","95","79","47","9","7"
"","Matt Calvert","CBJ","L","69","922.95","9","15","8","7","24","108","8.33","169","140","119","60","4","11"
"","Jacob Trouba","WPG","D","55","1204.3833333333","3","21","11","10","24","144","2.08","277","185","55","10","3","19"
"","Damon Severson","N.J","D","76","1495.55","9","15","11","4","24","121","7.44","238","164","58","15","5","16"
"","Tyler Bertuzzi","DET","L","48","691.2","7","17","9","8","24","83","8.43","153","130","103","64","2","11"
"","Vince Dunn","STL","D","75","1292.3166666667","5","19","6","13","24","138","3.62","284","176","67","9","5","17"
"","Ron Hainsey","TOR","D","80","1749.1833333333","4","19","8","11","23","73","5.48","190","116","41","3","5","9"
"","Deryk Engelland","VGK","D","79","1601.4666666667","5","18","13","5","23","108","4.63","217","156","39","5","7","10"
"","Brian Boyle","N.J","C","69","916.23333333333","13","10","7","3","23","120","10.83","196","160","106","53","6","5"
"","Loui Eriksson","VAN","L","50","813.46666666667","10","13","9","4","23","101","9.9","148","125","89","59","6","6"
"","Daniel Winnik","MIN","L","81","1099","6","17","9","8","23","82","7.32","151","113","81","38","4","5"
"","Mark Letestu","CBJ, EDM","C","80","1027.85","9","14","6","8","23","111","8.11","187","141","92","36","5","8"
"","Kevin Shattenkirk","NYR","D","46","932.48333333333","5","18","13","5","23","94","5.32","188","123","59","12","4","12"
"","Marcus Foligno","MIN","L","77","836.45","8","15","7","8","23","79","10.13","125","105","70","42","6","10"
"","Anthony Duclair","ARI, CHI","L","56","743.86666666667","11","12","8","4","23","97","11.34","175","130","110","51","2","14"
"","J.T. Compher","COL","L","69","1103.9833333333","13","10","7","3","23","131","9.92","231","176","139","53","8","10"
"","Markus Nutivaara","CBJ","D","61","977.36666666667","7","16","10","6","23","79","8.86","156","113","38","8","1","9"
"","Samuel Girard","COL, NSH","D","73","1288.3166666667","4","19","9","10","23","84","4.76","171","120","28","2","2","10"
"","Matt Cullen","MIN","C","79","939.48333333333","11","11","8","3","22","104","10.58","168","135","105","63","3","13"
"","Jeff Carter","L.A","C","27","481.75","13","9","6","3","22","85","15.29","146","120","101","50","7","12"
"","Troy Brouwer","CGY","R","76","1058.7833333333","6","16","11","5","22","79","7.59","170","131","76","35","5","13"
"","Tom Pyatt","OTT","L","81","1138.3666666667","7","15","8","7","22","103","6.8","157","124","99","56","5","14"
"","Jay Beagle","WSH","C","79","983.25","7","15","6","9","22","65","10.77","120","95","72","35","4","11"
"","Michael Del Zotto","VAN","D","82","1705.9333333333","6","16","7","9","22","128","4.69","243","174","69","16","4","13"
"","Tyler Ennis","MIN","L","73","874.05","8","14","7","7","22","115","6.96","202","161","113","56","6","15"
"","Marco Scandella","BUF","D","82","1911.9833333333","5","17","11","6","22","138","3.62","306","202","62","8","4","18"
"","Brenden Dillon","S.J","D","81","1402.9","5","17","8","9","22","88","5.68","203","140","40","5","3","11"
"","Derrick Pouliot","VAN","D","71","1267.4666666667","3","19","9","10","22","78","3.85","185","124","46","7","1","10"
"","Brendan Leipsic","VAN, VGK","L","58","761.86666666667","5","17","13","4","22","95","5.26","169","122","93","35","6","6"
"","Tim Schaller","BOS","C","82","1088.9833333333","12","10","6","4","22","133","9.02","210","171","125","66","11","14"
"","Michael Raffl","PHI","L","76","1007.35","13","9","4","5","22","96","13.54","153","132","104","58","8","3"
"","Sven Andrighetto","COL","R","50","724.31666666667","8","14","6","8","22","111","7.21","198","150","103","41","6","13"
"","Sonny Milano","CBJ","L","55","640.36666666667","14","8","4","4","22","69","20.29","122","101","70","30","1","9"
"","Denis Malgin","FLA","C","51","706.5","11","11","6","5","22","79","13.92","141","108","74","29","1","10"
"","Tyson Jost","COL","C","65","951.2","12","10","6","4","22","113","10.62","194","143","122","57","8","14"
"","Marian Gaborik","L.A, OTT","R","46","642.76666666667","11","10","10","0","21","80","13.75","166","123","95","34","5","10"
"","Patrick Sharp","CHI","L","70","901.85","10","11","7","4","21","143","6.99","243","181","120","40","10","13"
"","Kris Russell","EDM","D","78","1487.2","4","17","7","10","21","90","4.44","193","133","49","8","7","7"
"","Andrew MacDonald","PHI","D","66","1310.1833333333","6","15","2","13","21","82","7.32","194","121","39","6","3","16"
"","Kevin Connauton","ARI","D","73","1107.8666666667","11","10","2","8","21","102","10.78","226","148","47","10","2","8"
"","Jordan Weal","PHI","C","69","893.55","8","13","9","4","21","102","7.84","180","152","107","51","1","11"
"","Adam Lowry","WPG","C","45","670.03333333333","8","13","8","5","21","70","11.43","105","91","77","41","6","9"
"","Jonas Brodin","MIN","D","73","1577.1166666667","6","15","9","6","21","77","7.79","162","109","31","4","2","7"
"","Oscar Klefbom","EDM","D","66","1507.9166666667","5","16","7","9","21","203","2.46","399","276","80","11","7","19"
"","Jujhar Khaira","EDM","L","69","876.81666666667","11","10","4","6","21","73","15.07","158","112","99","43","5","4"
"","Matthew Benning","EDM","D","73","1261.55","6","15","7","8","21","111","5.41","237","164","59","3","2","21"
"","Artturi Lehkonen","MTL","L","66","1088.1333333333","12","9","7","2","21","164","7.32","290","220","179","89","13","22"
"","Ian Cole","CBJ, PIT","D","67","1190.95","5","15","7","8","20","84","5.95","183","120","42","3","0","5"
"","Jason Demers","ARI","D","69","1458.3833333333","6","14","7","7","20","95","6.32","225","147","68","15","5","17"
"","Dylan DeMelo","S.J","D","63","894.96666666667","0","20","10","10","20","67","0","140","102","27","5","2","11"
"","Andrew Shaw","MTL","R","51","806.28333333333","10","10","6","4","20","94","10.64","152","126","101","61","3","12"
"","Scott Laughton","PHI","C","81","900.71666666667","10","10","7","3","20","108","9.26","173","146","101","52","10","10"
"","Nikita Zadorov","COL","D","77","1498.8166666667","7","13","5","8","20","94","7.45","238","147","53","5","3","10"
"","Jake Virtanen","VAN","R","75","898.98333333333","10","10","4","6","20","130","7.69","245","198","140","47","13","12"
"","Jesse Puljujarvi","EDM","R","65","868.9","12","8","7","1","20","136","8.82","232","185","127","56","10","17"
"","Drake Caggiula","EDM","L","67","907.73333333333","13","7","5","2","20","104","12.5","181","136","123","60","11","14"
"","Jan Rutta","CHI","D","57","1097.5","6","14","5","9","20","71","8.45","169","100","50","4","2","6"
"","Scottie Upshall","STL","R","63","683.78333333333","7","12","7","5","19","71","9.86","120","93","51","25","5","6"
"","Benoit Pouliot","BUF","L","74","1012.5166666667","13","6","6","0","19","83","15.66","145","117","85","44","6","9"
"","Leo Komarov","TOR","C","74","1168.2333333333","7","12","4","8","19","114","6.14","172","157","113","55","4","8"
"","Zack Smith","OTT","L","68","1136.95","5","14","5","9","19","124","4.03","228","181","118","57","13","10"
"","Zack Kassian","EDM","R","74","863.53333333333","7","12","7","5","19","86","8.14","143","115","89","46","5","11"
"","Brandon Manning","PHI","D","65","1166.8833333333","7","12","6","6","19","111","6.31","232","160","52","10","3","20"
"","Austin Watson","NSH","L","76","937.2","14","5","2","3","19","96","14.58","170","133","83","42","9","6"
"","Nick Cousins","ARI","C","71","912.61666666667","12","7","2","5","19","119","10.08","179","146","112","58","4","12"
"","Nick Shore","CGY, L.A, OTT","C","64","906.78333333333","5","14","6","8","19","75","6.67","138","116","83","35","1","11"
"","Luke Glendening","DET","R","69","910.73333333333","11","8","5","3","19","88","12.5","122","115","86","47","8","9"
"","Cody Ceci","OTT","D","82","1913.8333333333","5","14","8","6","19","143","3.5","315","205","90","22","6","18"
"","Adam Pelech","NYI","D","78","1503.3833333333","3","16","6","10","19","106","2.83","227","150","45","12","4","7"
"","Brett Pesce","CAR","D","65","1358.7666666667","3","16","7","9","19","88","3.41","201","131","50","11","9","16"
"","Melker Karlsson","S.J","C","71","940.65","8","11","5","6","19","76","10.53","142","114","89","43","6","6"
"","Johnny Boychuk","NYI","D","58","1171.1333333333","6","12","8","4","18","141","4.26","282","200","36","3","4","9"
"","Ryan Callahan","T.B","R","67","892.51666666667","5","13","6","7","18","104","4.81","179","147","106","40","4","8"
"","Anton Stralman","T.B","D","80","1718.95","4","14","7","7","18","131","3.05","240","160","50","14","4","14"
"","Dan Girardi","T.B","D","77","1338.6666666667","6","12","4","8","18","93","6.45","170","127","34","6","4","11"
"","Cal Clutterbuck","NYI","R","76","971.95","8","10","5","5","18","101","7.92","168","127","89","37","6","11"
"","Colin Wilson","COL","C","56","735.41666666667","6","12","7","5","18","75","8","109","92","73","39","1","10"
"","Alex Chiasson","WSH","R","61","717.7","9","9","7","2","18","59","15.25","92","73","65","36","4","4"
"","John Moore","N.J","D","81","1620.75","7","11","5","6","18","141","4.96","265","197","48","8","8","15"
"","Brian Dumoulin","PIT","D","80","1649.4","5","13","7","6","18","102","4.9","213","142","55","9","2","11"
"","Derek Forbort","L.A","D","78","1621.4666666667","1","17","10","7","18","78","1.28","194","116","41","6","5","3"
"","Mike Reilly","MIN, MTL","D","57","852.86666666667","2","16","9","7","18","65","3.08","125","92","28","2","0","6"
"","Brad Hunt","VGK","D","45","749.11666666667","3","15","7","8","18","80","3.75","156","110","38","6","0","3"
"","Chandler Stephenson","WSH","C","67","795.21666666667","6","12","9","3","18","36","16.67","60","52","43","21","0","3"
"","Brandon Tanev","WPG","L","61","772.33333333333","8","10","3","7","18","79","10.13","135","111","78","41","5","9"
"","Francois Beauchemin","ANA","D","67","1159.8833333333","3","14","8","6","17","93","3.23","188","130","37","5","3","16"
"","Jussi Jokinen","CBJ, EDM, L.A, VAN","L","60","694.53333333333","5","12","6","6","17","73","6.85","138","104","81","32","1","9"
"","Nate Thompson","L.A, OTT","C","69","880.96666666667","5","12","7","5","17","53","9.43","108","78","49","16","4","6"
"","Nick Holden","BOS, NYR","D","73","1387.45","4","13","7","6","17","80","5","191","121","57","6","3","12"
"","Tommy Wingels","BOS, CHI","C, R","75","861.45","9","8","5","3","17","86","10.47","149","127","91","37","5","8"
"","Antoine Roussel","DAL","L","73","907.51666666667","5","12","9","3","17","85","5.88","171","126","100","49","7","10"
"","Casey Cizikas","NYI","C","64","845.76666666667","7","10","4","6","17","74","9.46","123","91","76","43","7","9"
"","Johan Larsson","BUF","C","80","1129.1833333333","4","13","5","8","17","86","4.65","140","122","58","28","9","4"
"","Dmitrij Jaskin","STL","R","76","946.08333333333","6","11","6","5","17","124","4.84","212","170","132","63","6","20"
"","Joel Edmundson","STL","D","69","1431.0833333333","7","10","5","5","17","124","5.65","265","187","70","13","3","13"
"","Jamie Oleksiak","DAL, PIT","D","68","1132.9166666667","5","12","4","8","17","81","6.17","170","120","31","6","2","6"
"","Antoine Vermette","ANA","C","64","879.98333333333","8","8","4","4","16","91","8.79","141","115","78","41","8","13"
"","Trevor Daley","DET","D","77","1593.6","9","7","3","4","16","103","8.74","197","146","56","15","4","10"
"","Shea Weber","MTL","D","26","659.05","6","10","5","5","16","75","8","163","114","30","4","0","13"
"","Brandon Dubinsky","CBJ","C","62","951.2","6","10","7","3","16","89","6.74","151","120","86","38","7","6"
"","Chris Stewart","CGY, MIN","R","54","580.08333333333","10","6","4","2","16","68","14.71","100","88","58","38","3","6"
"","David Savard","CBJ","D","81","1569.7833333333","4","12","8","4","16","145","2.76","271","189","64","10","1","18"
"","Radko Gudas","PHI","D","70","1197.1","2","14","10","4","16","142","1.41","257","188","32","3","7","14"
"","Devante Smith-Pelly","WSH","R","75","926.16666666667","7","9","7","2","16","103","6.8","195","155","105","42","3","6"
"","Chris Wagner","ANA, NYI","C, R","79","1048.9666666667","7","9","6","3","16","93","7.53","175","137","95","51","9","7"
"","Mark Pysyk","FLA","D","82","1538.4166666667","3","13","9","4","16","106","2.83","205","144","51","11","3","11"
"","Kevan Miller","BOS","D","68","1323.2","1","15","7","8","16","64","1.56","163","102","32","5","5","11"
"","Joe Morrow","MTL, WPG","D","56","937.05","6","10","2","8","16","83","7.23","181","123","37","3","1","11"
"","Nail Yakupov","COL","R","58","628.61666666667","9","7","5","2","16","94","9.57","163","131","83","17","5","10"
"","Pontus Aberg","EDM, NSH","L","53","644.86666666667","4","12","7","5","16","70","5.71","125","101","66","29","5","6"
"","Erik Gustafsson","CHI","D","35","649.43333333333","5","11","6","5","16","71","7.04","131","96","26","4","1","8"
"","Trevor van Riemsdyk","CAR","D","79","1346.9666666667","3","13","5","8","16","111","2.7","196","155","49","14","4","9"
"","Daniel Carr","MTL","L","38","461.08333333333","6","10","3","7","16","52","11.54","104","82","65","40","1","5"
"","Pierre-Edouard Bellemare","VGK","L","72","887.56666666667","6","10","6","4","16","92","6.52","164","132","74","23","7","6"
"","Joel Eriksson Ek","MIN","C","75","958.38333333333","6","10","4","6","16","124","4.84","191","155","95","47","6","14"
"","Braydon Coburn","T.B","D","72","1153.7166666667","1","14","9","5","15","73","1.37","162","106","39","8","4","8"
"","Brad Richardson","ARI","C","76","1122.15","3","12","7","5","15","105","2.86","185","137","117","58","4","17"
"","Drew Stafford","N.J","R","59","817.7","8","7","5","2","15","102","7.84","166","139","107","53","5","10"
"","Jordie Benn","MTL","D","77","1460.7833333333","4","11","5","6","15","106","3.77","217","142","37","4","6","11"
"","Brayden McNabb","VGK","D","76","1531.4333333333","5","10","2","8","15","88","5.68","193","123","37","4","5","9"
"","Nick Jensen","DET","D","81","1316.7","0","15","7","8","15","107","0","197","136","47","10","8","7"
"","Stephen Johns","DAL","D","75","1315.85","8","7","1","6","15","121","6.61","249","164","51","4","8","9"
"","Patrik Nemeth","COL","D","68","1350.2333333333","3","12","4","8","15","73","4.11","144","101","29","2","2","1"
"","Zemgus Girgensons","BUF","C","71","973.4","7","8","4","4","15","113","6.19","168","142","87","46","4","4"
"","Matt Grzelcyk","BOS","D","61","1021.1833333333","3","12","4","8","15","82","3.66","178","125","45","4","1","7"
"","Jordan Martinook","ARI","L","81","1134.8333333333","6","9","6","3","15","112","5.36","211","166","120","64","12","20"
"","Ryan Carpenter","S.J, VGK","C","52","655.16666666667","9","6","2","4","15","85","10.59","134","115","84","43","7","10"
"","Jordan Oesterle","CHI","D","55","1128.35","5","10","6","4","15","99","5.05","232","137","55","5","2","7"
"","Tomas Nosek","VGK","L","67","743.13333333333","7","8","6","2","15","92","7.61","154","128","112","49","8","11"
"","Derek MacKenzie","FLA","C","75","848.1","3","11","8","3","14","86","3.49","120","108","52","25","8","7"
"","Radim Vrbata","FLA","R","42","542.01666666667","5","9","5","4","14","88","5.68","144","116","70","20","7","7"
"","Alexandre Burrows","OTT","R","71","829.96666666667","6","8","2","6","14","90","6.67","156","127","80","38","6","6"
"","Ryan Kesler","ANA","C","44","793.53333333333","8","6","1","5","14","78","10.26","137","114","91","56","4","14"
"","Jannik Hansen","S.J","R","46","553.88333333333","2","12","8","4","14","54","3.7","99","82","45","16","3","6"
"","Paul Carey","NYR","C","60","615.6","7","7","5","2","14","51","13.73","93","72","50","28","3","4"
"","Luca Sbisa","VGK","D","30","585.61666666667","2","12","6","6","14","26","7.69","62","36","12","3","1","6"
"","Marcus Johansson","N.J","L","29","463.75","5","9","4","5","14","42","11.9","69","55","44","21","1","2"
"","Nicolas Deslauriers","MTL","L","58","672.5","10","4","2","2","14","77","12.99","127","98","74","39","6","5"
"","Ben Chiarot","WPG","D","57","870.55","2","12","7","5","14","57","3.51","132","84","24","0","1","7"
"","Scott Wilson","BUF, DET, PIT","C, L","69","842.26666666667","6","8","7","1","14","98","6.12","158","130","75","34","2","6"
"","Sean Kuraly","BOS","C","75","918.66666666667","6","8","5","3","14","134","4.48","210","173","112","49","13","10"
"","Logan Shaw","ANA, MTL","C, R","72","855.21666666667","4","10","5","5","14","105","3.81","198","152","108","51","7","18"
"","Brett Ritchie","DAL","R","71","769.58333333333","7","7","2","5","14","117","5.98","212","158","125","66","8","15"
"","Connor Murphy","CHI","D","76","1244.3833333333","2","12","5","7","14","109","1.83","237","152","62","9","4","15"
"","Barclay Goodrow","S.J","R","47","511.55","7","7","3","4","14","57","12.28","102","82","53","33","4","7"
"","Christian Djoos","WSH","D","63","884.16666666667","3","11","9","2","14","60","5","112","83","38","13","1","6"
"","Remi Elie","DAL","L","72","738.28333333333","6","8","7","1","14","70","8.57","131","105","71","38","3","11"
"","Nikolay Goldobin","VAN","R","38","468.66666666667","8","6","5","1","14","50","16","96","79","60","22","0","6"
"","Jack Roslovic","WPG","C","31","381.98333333333","5","9","6","3","14","38","13.16","75","63","41","13","2","3"
"","Jakob Chychrun","ARI","D","50","1012","4","10","6","4","14","102","3.92","235","160","68","10","6","19"
"","Neal Pionk","NYR","D","28","626.85","1","13","6","7","14","54","1.85","105","70","38","5","6","2"
"","Jason Chimera","ANA, NYI","L","74","762.16666666667","3","10","6","4","13","79","3.8","132","109","73","32","6","5"
"","Matt Hendricks","WPG","C","60","565.45","5","8","7","1","13","56","8.93","87","73","42","19","4","5"
"","Jonathan Ericsson","DET","D","81","1563.9833333333","3","10","7","3","13","86","3.49","153","103","30","5","2","5"
"","Andy Greene","N.J","D","81","1711.0333333333","3","10","5","5","13","93","3.23","196","137","42","8","0","13"
"","Robert Bortuzzo","STL","D","72","1065.7833333333","4","9","3","6","13","76","5.26","164","105","43","10","5","13"
"","Greg Pateryn","DAL","D","73","1431.9666666667","1","12","8","4","13","100","1","216","144","44","6","1","10"
"","Mark Barberio","COL","D","46","794.88333333333","3","10","5","5","13","52","5.77","124","83","33","5","1","10"
"","Alex Petrovic","FLA","D","67","982","2","11","5","6","13","60","3.33","147","95","26","4","1","8"
"","Adam Larsson","EDM","D","63","1381.7333333333","4","9","2","7","13","92","4.35","194","130","43","12","5","12"
"","Phillip Di Giuseppe","CAR","L","49","514.6","5","8","6","2","13","64","7.81","123","95","47","17","4","8"
"","John Hayden","CHI","R","47","508.76666666667","4","9","6","3","13","56","7.14","99","76","57","23","5","8"
"","Christian Folin","L.A","D","65","1017.7166666667","3","10","7","3","13","58","5.17","113","81","18","0","0","10"
"","Garnet Hathaway","CGY","R","59","680.43333333333","4","9","7","2","13","68","5.88","120","98","77","43","8","6"
"","Ivan Barbashev","STL","C","53","646.46666666667","7","6","3","3","13","45","15.56","103","78","70","34","1","3"
"","Gustav Forsling","CHI","D","41","785.4","3","10","4","6","13","82","3.66","163","100","40","9","2","14"
"","Travis Dermott","TOR","D","37","591.78333333333","1","12","4","8","13","54","1.85","106","68","29","2","0","6"
"","Nikita Zaitsev","TOR","D","60","1333.05","5","8","5","3","13","54","9.26","166","83","43","7","3","8"
"","Joel Ward","S.J","R","52","617.45","5","7","4","3","12","40","12.5","82","59","59","33","2","1"
"","Dominic Moore","TOR","C","50","514.86666666667","6","6","3","3","12","46","13.04","83","64","57","22","3","4"
"","Matt Stajan","CGY","C","68","743.56666666667","4","8","4","4","12","65","6.15","99","86","65","42","5","8"
"","Roman Polak","TOR","D","54","952.71666666667","2","10","5","5","12","47","4.26","127","80","26","4","3","8"
"","Karl Alzner","MTL","D","82","1646.6","1","11","5","6","12","84","1.19","188","122","32","5","1","9"
"","Matt Martin","TOR","L","50","399.41666666667","3","9","5","4","12","46","6.52","79","64","44","25","4","2"
"","Magnus Paajarvi","OTT, STL","L","79","983.58333333333","8","4","2","2","12","126","6.35","175","146","91","54","8","10"
"","Calvin de Haan","NYI","D","33","618.73333333333","1","11","6","5","12","44","2.27","91","63","20","3","2","7"
"","Connor Brickley","FLA","C","44","523.2","4","8","5","3","12","62","6.45","97","78","56","25","5","9"
"","Cory Conacher","T.B","C","36","359.8","8","4","2","2","12","45","17.78","77","63","47","21","1","7"
"","Scott Mayfield","NYI","D","47","838.7","2","10","4","6","12","58","3.45","141","84","31","3","0","12"
"","Markus Granlund","VAN","C","53","861.56666666667","8","4","4","0","12","93","8.6","149","117","80","49","4","13"
"","Ryan Murray","CBJ","D","44","810.83333333333","1","11","6","5","12","34","2.94","86","57","24","4","2","4"
"","Jake McCabe","BUF","D","53","1033.55","3","9","4","5","12","53","5.66","107","70","18","3","3","5"
"","Connor Carrick","TOR","D","47","711.33333333333","4","8","3","5","12","55","7.27","138","80","39","6","2","4"
"","Joakim Ryan","S.J","D","62","1038.5833333333","3","9","2","7","12","79","3.8","160","102","38","5","2","5"
"","Danny DeKeyser","DET","D","65","1320.9333333333","6","6","2","4","12","65","9.23","148","97","35","10","3","4"
"","Anton Slepyshev","EDM","L","50","590.51666666667","6","6","5","1","12","73","8.22","140","108","88","40","4","12"
"","Jacob de la Rose","MTL","L","55","651.5","4","8","2","6","12","53","7.55","108","76","56","20","4","7"
"","Madison Bowey","WSH","D","51","699.38333333333","0","12","4","8","12","47","0","104","73","31","8","1","5"
"","Curtis Lazar","CGY","C","65","640.71666666667","2","10","7","3","12","65","3.08","124","94","80","37","2","11"
"","Joshua Ho-Sang","NYI","R","22","314.15","2","10","6","4","12","18","11.11","35","26","18","7","1","2"
"","Anders Bjork","BOS","L","30","370.41666666667","4","8","4","4","12","30","13.33","74","47","42","12","4","5"
"","Dominik Simon","PIT","C","33","376.93333333333","4","8","4","4","12","36","11.11","68","51","46","19","2","3"
"","Torrey Mitchell","L.A, MTL","C","60","684.15","6","5","5","0","11","55","10.91","88","70","56","26","4","9"
"","Jack Johnson","CBJ","D","77","1505.0666666667","3","8","4","4","11","88","3.41","175","125","39","6","2","8"
"","Travis Hamonic","CGY","D","74","1531.6666666667","1","10","6","4","11","107","0.93","261","167","44","4","4","10"
"","Mark Borowiecki","OTT","D","52","761.4","3","8","3","5","11","66","4.55","132","98","36","10","5","7"
"","Dmitry Kulikov","WPG","D","62","1058.4666666667","3","8","5","3","11","48","6.25","117","76","15","4","0","4"
"","Gabriel Bourque","COL","L","58","632.45","5","6","4","2","11","44","11.36","84","70","61","36","4","6"
"","Byron Froese","MTL","C","48","555.81666666667","3","8","8","0","11","49","6.12","96","67","50","23","1","6"
"","Christopher Tanev","VAN","D","42","830.58333333333","2","9","2","7","11","31","6.45","51","39","7","0","1","2"
"","Oscar Lindberg","VGK","C","63","741.83333333333","9","2","1","1","11","81","11.11","143","115","71","28","6","9"
"","Tim Heed","S.J","D","29","464.56666666667","3","8","4","4","11","51","5.88","127","72","29","3","1","8"
"","Josh Archibald","ARI, PIT","R","42","501.7","5","6","5","1","11","42","11.9","86","62","40","17","1","2"
"","Gemel Smith","DAL","C","46","433.85","6","5","5","0","11","42","14.29","66","52","44","19","2","5"
"","Jake Dotchin","T.B","D","48","791.26666666667","3","8","5","3","11","48","6.25","115","81","20","3","2","7"
"","Anthony Cirelli","T.B","C","18","238.16666666667","5","6","5","1","11","26","19.23","41","33","29","19","1","1"
"","Noel Acciari","BOS","C","60","774.78333333333","10","1","1","0","11","66","15.15","113","92","78","37","5","9"
"","Troy Stecher","VAN","D","68","1279.1833333333","1","10","6","4","11","94","1.06","213","137","64","7","7","11"
"","David Kampf","CHI","C","46","588.78333333333","4","7","2","5","11","46","8.7","85","66","61","33","4","6"
"","Andreas Borgman","TOR","D","48","657","3","8","3","5","11","46","6.52","117","71","24","3","1","4"
"","Brooks Orpik","WSH","D","81","1568.55","0","10","3","7","10","54","0","133","75","29","2","0","4"
"","Matt Hunwick","PIT","D","42","735.45","4","6","3","3","10","52","7.69","105","71","22","8","0","6"
"","Martin Hanzal","DAL","C","38","536.13333333333","5","5","1","4","10","62","8.06","115","96","70","35","6","5"
"","Ryan Reaves","PIT, VGK","R","79","600.06666666667","4","6","2","4","10","42","9.52","79","64","50","29","0","6"
"","Christopher DiDomenico","OTT","L","24","282.86666666667","6","4","2","2","10","23","26.09","42","37","24","14","2","2"
"","Michael Stone","CGY","D","82","1373.2666666667","3","7","5","2","10","98","3.06","250","159","45","2","1","9"
"","Kyle Clifford","L.A","L","50","527.46666666667","6","4","2","2","10","81","7.41","133","110","75","31","3","8"
"","Tomas Jurco","CHI","L","29","365.9","6","4","2","2","10","45","13.33","85","64","54","28","3","6"
"","Steven Santini","N.J","D","36","729.86666666667","2","8","5","3","10","56","3.57","86","69","13","2","5","1"
"","Travis Sanheim","PHI","D","49","763.58333333333","2","8","5","3","10","72","2.78","151","100","35","6","3","11"
"","Frank Vatrano","BOS, FLA","C","41","444.4","7","3","3","0","10","72","9.72","121","96","64","20","5","3"
"","Michal Kempny","CHI, WSH","D","53","843.38333333333","3","7","5","2","10","82","3.66","168","111","35","4","4","8"
"","Victor Antipin","BUF","D","47","718.05","0","10","4","6","10","40","0","79","53","12","2","0","7"
"","Lee Stempniak","CAR","R","37","461.46666666667","3","6","5","1","9","41","7.32","88","63","50","22","2","7"
"","Alexei Emelin","NSH","D","76","1282.9833333333","1","8","5","3","9","59","1.69","135","94","22","3","1","7"
"","Niklas Hjalmarsson","ARI","D","48","993.5","1","8","4","4","9","32","3.13","84","49","24","3","3","3"
"","Alex Biega","VAN","D","44","660.9","1","8","4","4","9","79","1.27","150","106","55","15","5","6"
"","Derek Dorsett","VAN","R","20","305.63333333333","7","2","2","0","9","26","26.92","39","37","24","12","2","2"
"","Carl Gunnarsson","STL","D","63","1018.45","5","4","1","3","9","59","8.47","109","81","27","4","2","3"
"","Micheal Haley","FLA","C","75","584.31666666667","3","6","2","4","9","55","5.45","83","73","55","26","4","5"
"","Jimmy Hayes","N.J","R","33","393.61666666667","3","6","3","3","9","37","8.11","64","47","42","24","0","6"
"","Lance Bouma","CHI","L","53","564.46666666667","3","6","4","2","9","56","5.36","84","72","64","43","3","8"
"","Darren Archibald","VAN","R","27","401.2","4","5","2","3","9","28","14.29","55","45","37","15","2","4"
"","Nate Prosser","MIN, STL","D","57","767.35","3","6","4","2","9","27","11.11","74","46","12","1","1","6"
"","Andy Andreoff","L.A","L","45","422.53333333333","3","6","4","2","9","47","6.38","83","62","38","13","2","4"
"","Ty Rattie","EDM","R","14","216.6","5","4","3","1","9","32","15.63","50","42","32","12","2","7"
"","Nathan Beaulieu","BUF","D","59","940.88333333333","1","8","6","2","9","67","1.49","148","103","33","9","3","2"
"","Boo Nieves","NYR","C","28","285.56666666667","1","8","4","4","9","23","4.35","35","30","24","8","2","1"
"","Cedric Paquette","T.B","C","56","571.31666666667","5","4","2","2","9","64","7.81","109","82","71","31","1","7"
"","Robert Hagg","PHI","D","70","1269.7166666667","3","6","3","3","9","89","3.37","182","129","31","3","1","11"
"","Kasperi Kapanen","TOR","R","38","427.33333333333","7","2","1","1","9","55","12.73","87","74","53","22","0","5"
"","Ryan Donato","BOS","C","12","176.35","5","4","3","1","9","24","20.83","42","30","25","14","1","3"
"","Dylan Strome","ARI","C","21","271.88333333333","4","5","2","3","9","30","13.33","64","48","45","24","1","7"
"","Tage Thompson","STL","C","41","488.9","3","6","3","3","9","55","5.45","113","89","54","16","3","7"
"","Yohann Auvitu","EDM","D","33","447.33333333333","3","6","2","4","9","69","4.35","128","83","36","7","3","6"
"","Oscar Fantenberg","L.A","D","27","385.08333333333","2","7","2","5","9","33","6.06","74","54","15","3","0","7"
"","Kevin Bieksa","ANA","D","59","1063.1","0","8","4","4","8","66","0","147","110","33","5","3","8"
"","Johnny Oduya","OTT, PHI","D","52","889.71666666667","4","4","2","2","8","59","6.78","109","78","28","6","6","5"
"","Andrej Sekera","EDM","D","36","587.9","0","8","4","4","8","36","0","95","50","21","2","3","7"
"","Kris Versteeg","CGY","R","24","316.38333333333","3","5","3","2","8","49","6.12","88","61","43","9","2","7"
"","Marc Staal","NYR","D","72","1334.3166666667","1","7","4","3","8","68","1.47","147","100","49","20","2","3"
"","Ben Lovejoy","N.J","D","57","945.63333333333","2","6","2","4","8","74","2.7","140","102","26","3","2","7"
"","Brendan Smith","NYR","D","44","755.36666666667","1","7","4","3","8","66","1.52","119","85","35","12","1","6"
"","Jori Lehtera","PHI","C","62","651.9","3","5","1","4","8","45","6.67","74","55","41","18","1","3"
"","Dale Weise","PHI","R","46","486.33333333333","4","4","3","1","8","44","9.09","69","56","35","14","0","1"
"","Chris Wideman","OTT","D","16","184.9","3","5","0","5","8","24","12.5","45","32","14","3","2","4"
"","Jordan Nolan","BUF","C","69","676.03333333333","4","4","2","2","8","50","8","94","65","46","26","2","4"
"","Matt Irwin","NSH","D","50","671.6","2","6","2","4","8","62","3.23","145","91","33","3","4","8"
"","Tom Kuhnhackl","PIT","R","69","691.48333333333","2","6","4","2","8","63","3.17","92","75","55","29","7","3"
"","Lukas Sedlak","CBJ","C","53","498.21666666667","4","4","0","4","8","50","8","94","80","65","35","1","4"
"","Miikka Salomaki","NSH","R","58","596.21666666667","2","6","4","2","8","51","3.92","108","82","55","21","5","9"
"","Slater Koekkoek","T.B","D","35","393.23333333333","4","4","2","2","8","43","9.3","74","53","18","3","3","1"
"","Brett Kulak","CGY","D","71","921.98333333333","2","6","2","4","8","73","2.74","170","114","33","9","5","6"
"","MacKenzie Weegar","FLA","D","60","874.33333333333","2","6","2","4","8","58","3.45","133","83","28","3","2","10"
"","Gustav Olofsson","MIN","D","41","523.73333333333","0","8","2","6","8","22","0","48","29","14","5","3","6"
"","Haydn Fleury","CAR","D","67","1125.2666666667","0","8","2","6","8","86","0","181","110","35","2","3","8"
"","Tony DeAngelo","NYR","D","32","529.9","0","8","6","2","8","68","0","107","82","24","6","3","5"
"","Michael Amadio","L.A","C","37","344.51666666667","4","4","1","3","8","28","14.29","58","43","31","12","3","7"
"","Casey Nelson","BUF","D","37","694.86666666667","3","5","3","2","8","48","6.25","103","66","18","7","2","3"
"","Jakub Jerabek","MTL, WSH","D","36","587.55","2","6","3","3","8","33","6.06","75","53","16","4","0","4"
"","Jaromir Jagr","CGY","R","22","287","1","6","4","2","7","32","3.13","53","41","35","18","1","6"
"","Brian Gionta","BOS","R","20","261.35","2","5","3","2","7","42","4.76","59","50","25","11","2","6"
"","Chris Thorburn","STL","R","50","351.91666666667","1","6","5","1","7","35","2.86","55","44","30","16","2","4"
"","Jay Bouwmeester","STL","D","35","704.78333333333","2","5","2","3","7","45","4.44","101","66","14","3","0","4"
"","Cody Franson","CHI","D","23","382.16666666667","1","6","4","2","7","51","1.96","104","70","12","1","2","9"
"","Luke Schenn","ARI","D","64","1048.6","1","6","1","5","7","59","1.69","157","101","32","3","2","11"
"","Zac Rinaldo","ARI","C","53","598.05","5","2","1","1","7","56","8.93","98","74","46","23","3","4"
"","Joakim Nordstrom","CAR","L","75","792.88333333333","2","5","4","1","7","97","2.06","188","138","91","33","12","11"
"","Marcus Sorensen","S.J","L","32","324.76666666667","5","2","2","0","7","25","20","49","37","33","18","3","4"
"","Brandon Davidson","EDM, MTL, NYI","D","51","857.73333333333","4","3","2","1","7","63","6.35","124","87","19","2","3","7"
"","Fredrik Claesson","OTT","D","64","982","1","6","3","3","7","60","1.67","126","84","24","4","1","4"
"","Xavier Ouellet","DET","D","45","623.6","0","7","3","4","7","57","0","101","80","17","2","0","5"
"","J.T. Brown","ANA, T.B","R","47","426.33333333333","2","5","2","3","7","40","5","78","60","40","17","6","2"
"","Kevin Roy","ANA","L","25","341.21666666667","6","1","1","0","7","26","23.08","53","41","32","16","1","2"
"","Andrej Sustr","T.B","D","44","564.91666666667","2","5","5","0","7","45","4.44","94","66","23","4","4","1"
"","Tyler Motte","CBJ, VAN","C","46","516.31666666667","5","2","2","0","7","64","7.81","113","87","56","21","3","10"
"","Valentin Zykov","CAR","L","10","137.06666666667","3","4","3","1","7","18","16.67","28","24","21","13","0","5"
"","Tanner Fritz","NYI","C","34","425.73333333333","3","4","4","0","7","27","11.11","48","37","26","12","1","1"
"","Victor Mete","MTL","D","49","763.73333333333","0","7","5","2","7","43","0","97","62","27","8","4","7"
"","Toby Enstrom","WPG","D","43","732.35","1","5","2","3","6","31","3.23","68","50","10","3","0","2"
"","Marcus Kruger","CAR","C","48","520.18333333333","1","5","4","1","6","30","3.33","58","46","33","17","2","4"
"","Alexander Burmistrov","VAN","C","24","287.45","2","4","3","1","6","18","11.11","38","25","21","10","0","3"
"","Brendan Gaunce","VAN","C","37","492.46666666667","4","2","2","0","6","55","7.27","96","75","56","22","5","2"
"","Ben Hutton","VAN","D","61","1123.2833333333","0","6","2","4","6","103","0","204","139","59","11","6","6"
"","Jonny Brodzinski","L.A","C","35","332.68333333333","4","2","2","0","6","53","7.55","88","70","49","19","1","4"
"","Nicholas Baptiste","BUF","R","33","328.9","4","2","1","1","6","45","8.89","70","58","36","17","7","5"
"","Ross Johnston","NYI","L","24","224.03333333333","3","3","1","2","6","19","15.79","31","25","26","16","1","2"
"","Josh Jooris","CAR, PIT","R","40","390.61666666667","3","3","1","2","6","50","6","81","63","47","22","3","3"
"","Nikita Scherbak","MTL","R","26","347.81666666667","4","2","1","1","6","39","10.26","85","54","37","17","1","2"
"","Oskar Lindblom","PHI","L","23","335.46666666667","2","4","2","2","6","36","5.56","64","50","36","22","0","4"
"","Colin White","OTT","C","21","280.23333333333","2","4","2","2","6","24","8.33","42","33","20","11","2","2"
"","Brandon Carlo","BOS","D","76","1462.0166666667","0","6","3","3","6","76","0","144","103","31","11","4","4"
"","Markus Hannikainen","CBJ","L","33","276.28333333333","3","3","1","2","6","31","9.68","50","38","22","12","0","4"
"","Zach Aston-Reese","PIT","C","16","182.01666666667","4","2","2","0","6","20","20","32","24","20","12","1","5"
"","Dennis Seidenberg","NYI","D","28","500.71666666667","0","5","3","2","5","31","0","63","44","13","3","0","5"
"","David Booth","DET","L","28","195.18333333333","4","1","1","0","5","33","12.12","49","41","23","14","1","1"
"","David Schlemko","MTL","D","37","668.4","1","4","4","0","5","38","2.63","89","50","17","2","3","8"
"","Yannick Weber","NSH","D","47","566.7","2","3","3","0","5","40","5","82","57","24","8","2","4"
"","David Warsofsky","COL","D","16","214.31666666667","0","5","2","3","5","18","0","40","24","8","0","1","4"
"","Erik Gudbranson","VAN","D","52","957.88333333333","2","3","2","1","5","53","3.77","129","84","26","3","0","8"
"","Matthew Peca","T.B","C","10","136.7","2","3","2","1","5","17","11.76","22","19","15","8","0","2"
"","Max McCormick","OTT","L","30","250.53333333333","3","2","1","1","5","33","9.09","50","39","26","9","1","5"
"","Klas Dahlbeck","CAR","D","33","540.03333333333","1","4","1","3","5","43","2.33","93","61","15","0","1","3"
"","Reid Boucher","VAN","C","20","227.51666666667","3","2","0","2","5","37","8.11","56","47","34","17","0","6"
"","Scott Harrington","CBJ","D","32","425.58333333333","2","3","1","2","5","28","7.14","53","41","12","3","1","0"
"","Ryan Sproul","NYR","D","16","261.93333333333","1","4","3","1","5","15","6.67","46","28","11","2","0","2"
"","Ryan Murphy","MIN","D","21","399.23333333333","2","3","1","2","5","25","8","48","36","13","2","0","4"
"","Zack Mitchell","MIN","R","23","242.4","3","2","2","0","5","17","17.65","21","18","15","10","0","2"
"","Oskar Sundqvist","STL","C","42","440.01666666667","1","4","3","1","5","41","2.44","74","63","43","21","4","2"
"","Taylor Leier","PHI","L","39","409.03333333333","1","4","0","4","5","48","2.08","66","55","42","16","1","2"
"","Carter Rowney","PIT","R","44","411.25","2","3","1","2","5","21","9.52","43","31","25","10","1","5"
"","Chad Ruhwedel","PIT","D","44","691.93333333333","2","3","1","2","5","67","2.99","134","96","26","0","2","7"
"","John Gilmour","NYR","D","28","480.93333333333","2","3","1","2","5","61","3.28","129","88","33","7","1","10"
"","Brendan Guhle","BUF","D","18","325.9","0","5","3","2","5","37","0","69","48","18","3","0","3"
"","Vinni Lettieri","NYR","C","19","229.06666666667","1","4","2","2","5","28","3.57","57","48","20","11","1","3"
"","Casey Mittelstadt","BUF","C","6","84.116666666667","1","4","2","2","5","9","11.11","15","12","7","4","0","0"
"","Mike Fisher","NSH","C","16","197.51666666667","2","2","2","0","4","14","14.29","23","18","11","3","0","0"
"","Eric Fehr","S.J, TOR","C","18","212.06666666667","3","1","1","0","4","27","11.11","39","34","25","19","2","2"
"","Cody McLeod","NSH, NYR","L","48","354.4","1","3","1","2","4","36","2.78","48","43","32","22","3","5"
"","Taylor Chorney","CBJ, WSH","D","25","328.45","1","3","1","2","4","14","7.14","34","22","5","0","1","1"
"","Adam McQuaid","BOS","D","38","596.71666666667","1","3","0","3","4","39","2.56","75","53","10","1","0","3"
"","Mario Kempe","ARI","R","18","199.58333333333","2","2","1","1","4","20","10","29","24","16","5","2","1"
"","Luke Witkowski","DET","R","31","213.48333333333","1","3","1","2","4","16","6.25","28","23","16","9","3","1"
"","Peter Holland","NYR","C","23","285.05","1","3","2","1","4","30","3.33","46","37","20","11","1","4"
"","Jacob Josefson","BUF","C","39","443.68333333333","2","2","1","1","4","35","5.71","62","48","32","13","2","5"
"","Nic Dowd","L.A, VAN","C","56","590.01666666667","3","1","1","0","4","51","5.88","89","71","57","26","6","3"
"","Greg McKegg","PIT","C","26","251.66666666667","2","2","2","0","4","21","9.52","32","27","24","10","2","2"
"","Nick Seeler","MIN","D","22","319.76666666667","0","4","3","1","4","17","0","39","25","11","2","0","4"
"","Josh Leivo","TOR","L","16","169.08333333333","1","3","1","2","4","25","4","41","37","25","9","2","1"
"","Daniel O'Regan","BUF, S.J","C","21","209.33333333333","0","4","3","1","4","17","0","26","20","17","9","0","4"
"","Paul LaDue","L.A","D","12","167.65","3","1","1","0","4","13","23.08","33","18","6","0","1","0"
"","Kurtis MacDermid","L.A","D","34","394.53333333333","1","3","1","2","4","19","5.26","43","27","10","2","1","3"
"","Ian McCoshen","FLA","D","38","572.88333333333","3","1","0","1","4","26","11.54","65","46","15","1","2","2"
"","Adam Erne","T.B","L","23","232.73333333333","3","1","0","1","4","29","10.34","49","42","29","12","1","2"
"","Justin Bailey","BUF","R","12","135.33333333333","3","1","0","1","4","19","15.79","30","25","18","9","1","0"
"","Mirco Mueller","N.J","D","28","466.91666666667","0","4","1","3","4","19","0","42","25","8","1","0","0"
"","Dennis Rasmussen","ANA","C","27","240.51666666667","1","3","0","3","4","19","5.26","32","25","22","7","1","1"
"","Julius Honka","DAL","D","42","546.38333333333","1","3","2","1","4","42","2.38","101","59","25","1","2","4"
"","Marcus Pettersson","ANA","D","22","299.38333333333","1","3","1","2","4","16","6.25","31","21","4","0","0","1"
"","Anton Lindholm","COL","D","48","632.11666666667","0","4","2","2","4","22","0","65","32","14","2","2","5"
"","Evgeny Svechnikov","DET","R","14","123.48333333333","2","2","2","0","4","15","13.33","26","21","12","7","0","0"
"","Ethan Bear","EDM","D","18","335.38333333333","1","3","2","1","4","20","5","45","28","7","0","0","1"
"","Filip Chlapik","OTT","C","20","201.45","1","3","3","0","4","21","4.76","38","33","17","6","0","4"
"","Austin Czarnik","BOS","C","10","109.11666666667","0","4","3","1","4","7","0","12","11","8","3","0","1"
"","Dean Kukan","CBJ","D","11","135.98333333333","0","4","1","3","4","12","0","18","14","4","1","0","0"
"","Luke Kunin","MIN","C","19","246.58333333333","2","2","1","1","4","32","6.25","54","40","26","10","3","2"
"","Maxim Mamin","FLA","C","26","273.53333333333","3","1","0","1","4","28","10.71","47","37","20","8","1","3"
"","Sebastian Aho","NYI","D","22","357.4","1","3","1","2","4","24","4.17","54","33","16","1","0","2"
"","Kyle Quincey","MIN","D","18","256.96666666667","0","3","0","3","3","11","0","18","13","3","1","1","0"
"","Marc Methot","DAL","D","36","643.8","1","2","0","2","3","25","4","61","43","14","2","1","2"
"","Shawn Matthias","WPG","L","27","301.66666666667","1","2","2","0","3","26","3.85","39","30","30","17","3","2"
"","Nikolay Kulemin","NYI","L","13","155.18333333333","1","2","1","1","3","7","14.29","13","9","9","6","2","1"
"","Matt Bartkowski","CGY","D","18","240.21666666667","0","3","1","2","3","21","0","37","26","3","0","0","1"
"","Brandon Pirri","VGK","C","2","35.233333333333","3","0","0","0","3","11","27.27","15","14","6","3","0","1"
"","Jordan Szwarz","BOS","R","12","138.11666666667","0","3","2","1","3","19","0","23","21","15","7","0","4"
"","Jon Merrill","VGK","D","34","546.91666666667","1","2","1","1","3","30","3.33","59","43","15","3","1","6"
"","Kevin Gravel","L.A","D","16","224.53333333333","0","3","1","2","3","20","0","45","31","7","1","0","5"
"","Anthony Bitetto","NSH","D","32","430.06666666667","1","2","0","2","3","25","4","54","38","11","2","2","0"
"","Rob O'Gara","BOS, NYR","D","30","465.38333333333","0","3","2","1","3","21","0","61","35","19","3","1","6"
"","Iiro Pakarinen","EDM","R","40","407.73333333333","2","1","1","0","3","50","4","98","76","45","17","5","5"
"","Alan Quine","NYI","C","21","246.45","0","3","2","1","3","15","0","31","20","17","8","1","2"
"","Rocco Grimaldi","COL","C","6","57.85","1","2","1","1","3","7","14.29","9","8","7","4","1","0"
"","Seth Griffith","BUF","C","21","221.88333333333","2","1","1","0","3","15","13.33","21","19","12","6","0","2"
"","Tomas Hyka","VGK","R","10","120.53333333333","1","2","2","0","3","15","6.67","20","17","15","8","1","0"
"","Andreas Johnsson","TOR","L","9","105.3","2","1","0","1","3","19","10.53","27","23","19","12","2","0"
"","Marko Dano","WPG","C","23","165.3","2","1","0","1","3","22","9.09","38","33","20","10","1","1"
"","Carl Dahlstrom","CHI","D","11","192.65","0","3","2","1","3","12","0","30","15","16","2","2","5"
"","William Carrier","VGK","L","37","327.11666666667","1","2","1","1","3","52","1.92","93","77","52","31","2","3"
"","Trevor Murphy","ARI","D","8","113.88333333333","1","2","0","2","3","5","20","14","9","3","0","0","1"
"","Frederick Gaudreau","NSH","C","20","183.21666666667","0","3","0","3","3","14","0","32","23","13","7","0","1"
"","Roland McKeown","CAR","D","10","134.1","0","3","0","3","3","7","0","26","12","6","1","0","0"
"","Warren Foegele","CAR","L","2","23.85","2","1","1","0","3","6","33.33","8","7","4","2","2","1"
"","Sammy Blais","STL","L","11","118.5","1","2","0","2","3","9","11.11","20","17","15","5","2","1"
"","Dylan Sikura","CHI","R","5","67","0","3","1","2","3","9","0","15","10","6","2","0","0"
"","Joe Hicketts","DET","D","5","86.733333333333","0","3","1","2","3","2","0","15","7","0","0","1","0"
"","A.J. Greer","COL","L","17","125.68333333333","0","3","2","1","3","13","0","20","15","8","3","1","0"
"","Noah Juulsen","MTL","D","23","446.73333333333","1","2","1","1","3","33","3.03","70","41","11","2","1","2"
"","Daniel Sprong","PIT","R","8","111.83333333333","2","1","1","0","3","22","9.09","33","30","25","10","1","1"
"","Tanner Kero","CHI","C","8","91.5","1","2","1","1","3","7","14.29","10","9","5","3","2","1"
"","Andrei Mironov","COL","D","10","110.46666666667","1","2","0","2","3","3","33.33","9","4","2","1","2","0"
"","Christian Wolanin","OTT","D","10","146.46666666667","1","2","0","2","3","14","7.14","20","16","8","1","0","1"
"","Kailer Yamamoto","EDM","R","9","136.43333333333","0","3","1","2","3","23","0","41","31","29","17","2","7"
"","Filip Chytil","NYR","C","9","122.48333333333","1","2","1","1","3","21","4.76","31","27","21","15","0","4"
"","Chris Kelly","ANA","C","12","91.933333333333","0","2","2","0","2","5","0","10","7","7","2","2","0"
"","Paul Martin","S.J","D","14","206.65","0","2","2","0","2","6","0","16","11","5","1","1","2"
"","Josh Gorges","BUF","D","34","507.96666666667","0","2","1","1","2","15","0","35","25","7","0","0","3"
"","Eric Gryba","EDM","D","21","309.4","0","2","2","0","2","19","0","57","34","9","1","0","3"
"","Justin Falk","BUF","D","46","740.06666666667","1","1","0","1","2","36","2.78","61","45","9","3","1","1"
"","Jordan Schroeder","CBJ","L","21","157.01666666667","1","1","1","0","2","20","5","31","28","18","8","1","3"
"","Gabriel Dumont","OTT, T.B","C","30","271.26666666667","1","1","0","1","2","38","2.63","61","51","31","13","2","4"
"","Curtis McKenzie","DAL","L","7","56.716666666667","0","2","2","0","2","11","0","22","16","15","9","1","3"
"","Justin Holl","TOR","D","2","34.716666666667","2","0","0","0","2","2","100","4","4","1","0","0","0"
"","Shane Prince","NYI","L","14","168.03333333333","1","1","1","0","2","20","5","37","26","23","6","1","2"
"","Andy Welinski","ANA","D","7","113.21666666667","0","2","1","1","2","6","0","14","12","2","0","0","1"
"","Adam Clendening","ARI","D","5","79.666666666667","0","2","0","2","2","4","0","11","8","2","0","0","0"
"","Duncan Siemens","COL","D","16","197.1","1","1","0","1","2","14","7.14","30","20","5","0","0","0"
"","Dominic Toninato","COL","C","37","292.21666666667","0","2","1","1","2","25","0","51","36","31","12","5","6"
"","Ashton Sautner","VAN","D","5","66.8","0","2","1","1","2","3","0","5","4","1","1","0","0"
"","Tucker Poolman","WPG","D","24","301.51666666667","1","1","1","0","2","27","3.7","63","46","7","1","2","2"
"","Peter Cehlarik","BOS","L","6","83.6","1","1","0","1","2","3","33.33","6","4","5","3","0","1"
"","Jason Dickinson","DAL","C","27","230.41666666667","0","2","1","1","2","16","0","34","22","20","10","1","0"
"","Nic Petan","WPG","L","15","126.2","2","0","0","0","2","16","12.5","27","19","12","6","0","1"
"","Kerby Rychel","MTL","L","4","44.116666666667","1","1","0","1","2","7","14.29","9","9","4","2","0","2"
"","Louie Belpedio","MIN","D","1","15.783333333333","0","2","0","2","2","0","0","4","2","0","0","0","0"
"","Matthew Highmore","CHI","C","13","157.98333333333","2","0","0","0","2","27","7.41","43","34","28","10","3","1"
"","Nikita Soshnikov","STL, TOR","R","15","165.26666666667","1","1","1","0","2","17","5.88","27","23","12","5","1","0"
"","Gabriel Carlsson","CBJ","D","14","158.61666666667","0","2","0","2","2","18","0","26","19","5","0","0","2"
"","Kalle Kossila","ANA","C, L","10","90.85","1","1","1","0","2","9","11.11","13","13","5","3","0","0"
"","Lias Andersson","NYR","C","7","83.616666666667","1","1","1","0","2","5","20","10","8","4","2","0","0"
"","Spencer Foo","CGY","R","4","63.416666666667","2","0","0","0","2","16","12.5","22","20","16","11","1","1"
"","Brooks Laich","L.A","C","12","134.31666666667","0","1","0","1","1","10","0","21","14","7","3","0","0"
"","Patrick Eaves","ANA","R","2","32.916666666667","1","0","0","0","1","3","33.33","8","6","3","2","0","0"
"","Jared Boll","ANA","R","10","44.25","1","0","0","0","1","4","25","5","5","3","1","0","0"
"","Steven Kampfer","NYR","D","22","379.53333333333","0","1","1","0","1","31","0","52","43","13","3","2","1"
"","Jim O'Brien","OTT","C","10","87.55","0","1","1","0","1","11","0","15","14","9","4","0","2"
"","Paul Postma","BOS","D","14","143.16666666667","0","1","1","0","1","14","0","33","23","11","2","2","1"
"","Jason Garrison","VGK","D","8","152.53333333333","0","1","0","1","1","7","0","15","9","2","0","0","1"
"","Zach Bogosian","BUF","D","18","344.81666666667","0","1","1","0","1","29","0","48","35","12","4","0","2"
"","Aaron Ness","WSH","D","8","101.81666666667","0","1","0","1","1","2","0","3","2","1","0","0","0"
"","Landon Ferraro","MIN","C","2","8.8333333333333","1","0","0","0","1","3","33.33","3","3","3","2","1","1"
"","Mike Liambas","ANA","L","7","37.016666666667","0","1","1","0","1","3","0","3","3","2","1","0","0"
"","Kenny Agostino","BOS","L","5","60.216666666667","0","1","0","1","1","11","0","17","16","13","5","0","3"
"","Freddie Hamilton","ARI, CGY","C","16","143.68333333333","0","1","1","0","1","12","0","22","16","8","4","0","1"
"","Erik Burgdoerfer","OTT","D","2","26.833333333333","0","1","1","0","1","2","0","2","2","1","0","0","1"
"","Taylor Fedun","BUF","D","7","102.78333333333","0","1","0","1","1","8","0","20","9","3","1","0","2"
"","Matt Read","PHI","R","19","207.13333333333","1","0","0","0","1","16","6.25","34","25","22","14","0","0"
"","Travis Boyd","WSH","C","8","70.6","0","1","1","0","1","2","0","5","4","3","2","0","1"
"","Kyle Rau","MIN","C","3","33.083333333333","0","1","0","1","1","4","0","7","5","5","2","0","0"
"","Stefan Matteau","VGK","C","8","65.616666666667","0","1","1","0","1","8","0","19","13","7","2","0","1"
"","Jordan Schmaltz","STL","D","13","142.63333333333","0","1","1","0","1","5","0","13","6","0","0","0","0"
"","Patrick Sieloff","OTT","D","1","11.183333333333","1","0","0","0","1","3","33.33","4","3","0","0","0","0"
"","Jaycob Megna","ANA","D","14","219.98333333333","0","1","1","0","1","7","0","19","14","3","0","0","0"
"","Nick Paul","OTT","L","11","86.866666666667","1","0","0","0","1","11","9.09","21","15","8","2","2","1"
"","Ben Harpur","OTT","D","41","610.33333333333","0","1","1","0","1","26","0","70","41","15","2","2","5"
"","Michael McCarron","MTL","R","18","157.71666666667","0","1","1","0","1","15","0","27","20","14","2","1","2"
"","Chris Bigras","COL","D","15","207.9","0","1","0","1","1","8","0","23","13","4","1","0","1"
"","Dillon Heatherington","DAL","D","6","65.1","0","1","0","1","1","6","0","10","9","0","0","0","0"
"","Frederik Gauthier","TOR","C","9","78.683333333333","1","0","0","0","1","12","8.33","16","14","14","3","1","1"
"","Jean-Sebastien Dea","PIT","C","5","27.45","1","0","0","0","1","1","100","1","1","1","1","1","0"
"","Nathan Walker","EDM, WSH","L","9","85.016666666667","1","0","0","0","1","6","16.67","11","7","5","1","0","0"
"","Brendan Lemieux","WPG","L","9","71.466666666667","1","0","0","0","1","6","16.67","10","8","4","1","0","0"
"","Brett Lernout","MTL","D","18","301.05","0","1","0","1","1","14","0","38","24","4","0","1","3"
"","Lucas Wallmark","CAR","C","11","104.43333333333","1","0","0","0","1","16","6.25","26","21","15","8","4","2"
"","Shane Gersich","WSH","L","3","27.05","0","1","1","0","1","4","0","6","4","3","2","0","0"
"","Dryden Hunt","FLA","L","11","116.18333333333","0","1","1","0","1","12","0","23","20","4","2","0","0"
"","Jordan Greenway","MIN","L","6","68.65","0","1","1","0","1","4","0","7","6","5","1","0","0"
"","Lawson Crouse","ARI","L","11","120.33333333333","1","0","0","0","1","13","7.69","24","19","11","7","1","1"
"","Andreas Martinsen","CHI","L","9","113.76666666667","1","0","0","0","1","14","7.14","26","17","10","4","1","2"
"","Sami Niku","WPG","D","1","15.216666666667","1","0","0","0","1","2","50","3","2","2","1","0","0"
"","Ryan Lomberg","CGY","L","7","43.75","0","1","1","0","1","5","0","6","5","2","2","0","1"
"","Nick Lappin","N.J","R","6","58.566666666667","1","0","0","0","1","7","14.29","11","9","5","3","0","2"
"","Logan Brown","OTT","C","4","32.516666666667","0","1","0","1","1","4","0","7","6","6","3","0","0"
"","Henrik Borgstrom","FLA","C","4","50.633333333333","1","0","0","0","1","6","16.67","10","8","5","4","1","1"
"","Alexander Nylander","BUF","R","3","38.583333333333","1","0","0","0","1","2","50","4","4","4","3","0","0"
"","Blake Hillman","CHI","D","4","72.116666666667","1","0","0","0","1","5","20","10","7","1","0","0","0"
"","Vadim Shipachyov","VGK","C","3","31.766666666667","1","0","0","0","1","3","33.33","8","8","5","1","0","0"
"","Owen Tippett","FLA","R","7","77.816666666667","1","0","0","0","1","17","5.88","31","21","11","1","0","1"
"","Victor Ejdsell","CHI","C","6","79.9","0","1","0","1","1","7","0","16","8","9","0","0","0"
"","Calle Rosen","TOR","D","4","51.15","0","1","0","1","1","5","0","13","8","5","0","0","2"
"","Henrik Haapala","FLA","L","5","68.5","0","1","0","1","1","3","0","3","3","2","1","0","0"
"","Daniel Brickley","L.A","D","1","10.8","0","1","0","1","1","0","0","1","0","0","0","0","0"
"","Mark Streit","MTL","D","2","28.433333333333","0","0","0","0","0","3","0","4","3","1","0","0","0"
"","Ales Hemsky","MTL","R","7","69.45","0","0","0","0","0","5","0","10","9","4","4","0","0"
"","Steve Bernier","NYI","R","4","40.216666666667","0","0","0","0","0","4","0","6","5","6","4","0","0"
"","Matt Moulson","BUF","L","14","144.01666666667","0","0","0","0","0","13","0","28","23","15","6","0","0"
"","Tanner Glass","CGY","L","16","150.08333333333","0","0","0","0","0","14","0","25","23","14","7","0","2"
"","Adam Cracknell","DAL, NYR","R","5","38.55","0","0","0","0","0","6","0","8","6","2","1","1","0"
"","Mike Blunden","OTT","R","1","6.5166666666667","0","0","0","0","0","1","0","1","1","1","1","0","0"
"","Chris Butler","STL","D","6","79.833333333333","0","0","0","0","0","2","0","7","2","1","0","0","1"
"","Nathan Gerbe","CBJ","C","2","17.2","0","0","0","0","0","1","0","1","1","0","0","0","0"
"","Cal O'Reilly","MIN","C","1","8.2666666666667","0","0","0","0","0","1","0","1","1","0","0","0","0"
"","Will O'Neill","PHI","D","1","9.4166666666667","0","0","0","0","0","3","0","3","3","1","0","0","0"
"","Matt Beleskey","BOS, NYR","L","15","164.61666666667","0","0","0","0","0","17","0","38","31","11","7","2","2"
"","Korbinian Holzer","ANA","D","16","185.85","0","0","0","0","0","10","0","18","14","6","1","0","1"
"","Anthony Peluso","WSH","R","2","9.2833333333333","0","0","0","0","0","0","0","0","0","0","0","0","0"
"","Brad Malone","EDM","C","7","55.916666666667","0","0","0","0","0","9","0","10","9","7","5","0","0"
"","Zac Dalpe","CBJ","C","12","89.3","0","0","0","0","0","18","0","25","21","10","3","1","1"
"","Zach Redmond","BUF","D","3","43.433333333333","0","0","0","0","0","7","0","10","7","3","1","0","0"
"","Dalton Prout","N.J","D","4","55.95","0","0","0","0","0","5","0","9","7","2","0","0","0"
"","Brian Lashoff","DET","D","1","4.0333333333333","0","0","0","0","0","0","0","0","0","0","0","0","0"
"","Wade Megan","STL","C","1","8.35","0","0","0","0","0","1","0","1","1","1","0","0","0"
"","Ben Sexton","OTT","C","2","20.55","0","0","0","0","0","1","0","1","1","1","0","0","0"
"","Martin Marincin","TOR","D","2","33.35","0","0","0","0","0","0","0","3","2","0","0","0","0"
"","Mark Alt","COL, PHI","D","15","186.73333333333","0","0","0","0","0","11","0","29","17","3","0","0","3"
"","Michael Bournival","T.B","L","5","46.733333333333","0","0","0","0","0","5","0","7","7","5","1","2","0"
"","Beau Bennett","STL","R","6","64.816666666667","0","0","0","0","0","6","0","14","10","5","3","0","0"
"","Michael Chaput","VAN","C","9","88.083333333333","0","0","0","0","0","2","0","8","7","5","3","0","0"
"","Zach Trotman","PIT","D","3","38.35","0","0","0","0","0","6","0","10","7","0","0","0","0"
"","Marek Hrivik","CGY","L","3","25.516666666667","0","0","0","0","0","2","0","5","4","3","3","0","0"
"","Andrew Crescenzi","L.A","C","2","15.716666666667","0","0","0","0","0","0","0","1","1","1","1","0","0"
"","Alex Broadhurst","CBJ","C","2","20.083333333333","0","0","0","0","0","1","0","3","3","3","0","0","1"
"","Frank Corrado","PIT","D","5","57.5","0","0","0","0","0","6","0","11","9","1","0","0","0"
"","Chase Balisy","FLA","C","8","78.533333333333","0","0","0","0","0","6","0","13","9","7","4","1","0"
"","Tyler Graovac","WSH","C","5","33.7","0","0","0","0","0","1","0","2","2","2","2","1","0"
"","Blake Pietila","N.J","L","2","18.916666666667","0","0","0","0","0","1","0","4","4","1","0","0","0"
"","Steven Fogarty","NYR","C","1","12.266666666667","0","0","0","0","0","1","0","2","2","1","1","1","0"
"","Keegan Lowe","EDM","D","2","27.8","0","0","0","0","0","4","0","10","5","5","2","0","1"
"","Daniel Catenacci","NYR","C","1","11.05","0","0","0","0","0","1","0","1","1","1","1","0","0"
"","Matt Tennyson","BUF","D","15","269.58333333333","0","0","0","0","0","25","0","47","31","8","0","0","3"
"","Nicolas Kerdiles","ANA","L","2","7.5","0","0","0","0","0","0","0","1","0","0","0","0","0"
"","Trevor Carrick","CAR","D","1","7.5333333333333","0","0","0","0","0","1","0","1","1","0","0","0","0"
"","Christoph Bertschy","MIN","C","1","5.3833333333333","0","0","0","0","0","0","0","0","0","0","0","0","0"
"","Joseph Blandisi","ANA","C","3","35.033333333333","0","0","0","0","0","4","0","4","4","1","0","0","0"
"","Liam O'Brien","WSH","C","3","20.75","0","0","0","0","0","1","0","1","1","0","0","0","0"
"","Jayson Megna","VAN","C","1","4.3","0","0","0","0","0","0","0","0","0","0","0","0","0"
"","Anton Blidh","BOS","L","1","10.383333333333","0","0","0","0","0","0","0","0","0","0","0","0","0"
"","Carson Soucy","MIN","D","3","44.533333333333","0","0","0","0","0","4","0","5","4","0","0","0","0"
"","Hudson Fasching","BUF","R","5","48.5","0","0","0","0","0","1","0","6","5","3","2","0","0"
"","Tyrell Goulbourne","PHI","L","9","50.25","0","0","0","0","0","2","0","5","4","3","3","0","0"
"","Justin Auger","L.A","R","2","15.983333333333","0","0","0","0","0","1","0","3","2","2","0","1","0"
"","Morgan Klimchuk","CGY","L","1","7.4166666666667","0","0","0","0","0","0","0","1","1","1","1","0","0"
"","Laurent Dauphin","ARI","C","2","14.45","0","0","0","0","0","1","0","1","1","0","0","0","0"
"","Samuel Morin","PHI","D","2","31.616666666667","0","0","0","0","0","1","0","3","2","1","0","0","0"
"","Colby Cave","BOS","C","3","34.366666666667","0","0","0","0","0","2","0","4","3","3","1","0","0"
"","Dakota Mermis","ARI","D","9","98.866666666667","0","0","0","0","0","7","0","11","8","0","0","0","0"
"","Curtis Valk","FLA","C","1","3.4166666666667","0","0","0","0","0","0","0","0","0","0","0","0","0"
"","Rinat Valiev","MTL","D","2","23.616666666667","0","0","0","0","0","2","0","6","4","1","0","0","0"
"","Joel Hanley","ARI","D","5","55.65","0","0","0","0","0","2","0","8","7","2","1","0","1"
"","Michael Dal Colle","NYI","L","4","53.416666666667","0","0","0","0","0","1","0","2","2","1","0","0","0"
"","John Quenneville","N.J","C","2","26.583333333333","0","0","0","0","0","5","0","9","6","4","1","1","0"
"","Andreas Englund","OTT","D","1","11.35","0","0","0","0","0","0","0","0","0","0","0","0","0"
"","Vladislav Kamenev","COL","C","3","26.466666666667","0","0","0","0","0","1","0","1","1","0","0","0","0"
"","Dominic Turgeon","DET","C","5","46.166666666667","0","0","0","0","0","3","0","5","4","1","1","1","0"
"","Andrew Mangiapane","CGY","L","10","89.3","0","0","0","0","0","7","0","19","15","10","7","2","2"
"","Jack Rodewald","OTT","R","4","29.2","0","0","0","0","0","0","0","3","2","1","0","0","0"
"","Danick Martel","PHI","L","4","40.866666666667","0","0","0","0","0","6","0","12","11","9","5","1","0"
"","Rasmus Andersson","CGY","D","10","154.38333333333","0","0","0","0","0","8","0","23","13","7","0","0","1"
"","Nicholas Merkley","ARI","R","1","13.5","0","0","0","0","0","0","0","1","1","1","0","0","0"
"","Nicolas Roy","CAR","C","1","10.766666666667","0","0","0","0","0","1","0","2","1","0","0","0","0"
"","Kyle Capobianco","ARI","D","1","13.55","0","0","0","0","0","0","0","1","1","0","0","0","0"
"","Christian Jaros","OTT","D","2","15.933333333333","0","0","0","0","0","0","0","2","0","0","0","0","0"
"","Troy Terry","ANA","R","2","20.416666666667","0","0","0","0","0","3","0","3","3","2","0","0","0"
"","Adam Gaudette","VAN","C","5","63.933333333333","0","0","0","0","0","9","0","20","14","13","5","0","0"
"","Kevin Rooney","N.J","C","1","11.766666666667","0","0","0","0","0","3","0","4","4","3","2","0","0"
"","Kyle Criscuolo","BUF","C","9","72.133333333333","0","0","0","0","0","5","0","8","6","6","3","0","0"
"","Janne Kuokkanen","CAR","C","4","44.25","0","0","0","0","0","6","0","10","8","7","4","0","1"
"","Dylan Gambrell","S.J","C","3","31.666666666667","0","0","0","0","0","1","0","3","2","0","0","0","0"
"","Giovanni Fiore","ANA","L","1","7.8833333333333","0","0","0","0","0","0","0","1","1","1","0","0","0"
"","Eeli Tolvanen","NSH","R","3","36.333333333333","0","0","0","0","0","3","0","6","5","3","2","0","1"
"","Alex Formenton","OTT","L","1","4.9","0","0","0","0","0","0","0","0","0","0","0","0","0"
"","Martin Necas","CAR","C","1","6.9","0","0","0","0","0","0","0","0","0","0","0","0","0"
"","Justin Kloos","MIN","C","1","8.65","0","0","0","0","0","0","0","0","0","0","0","0","0"
"","Philip Holm","VAN","D","1","15.2","0","0","0","0","0","0","0","1","1","0","0","0","0"
"","Zach Whitecloud","VGK","D","1","16.7","0","0","0","0","0","0","0","1","0","0","0","0","0"
"","Mitch Reinke","STL","D","1","13.083333333333","0","0","0","0","0","1","0","3","2","0","0","0","0"
"","Eric Robinson","CBJ","L","1","11.35","0","0","0","0","0","2","0","3","3","1","0","0","0"